{
	"Map": {
		"id": 6,
		"map_display_x": 0,
		"map_display_y": 0,
		"width": 20,
		"height": 15,
		"xsize": 20,
		"ysize": 15,
		"zsize": 3,
		"Name" : "Kurt's house",
		"Parent" : "Route 1",
		"Tileset" : "Interior general",
		"BattleBack" : "",
		"Autoplay_bgm" : true,
		"BGM" : "route",
		"Autoplay_bgs" : false,
		"BGS" : "",
		"Encounter_list" : [],
		"Encounter_step" : 30,
		"table": [[[404, 404, 404, 404, 404, 404, 404, 404, 404, 404, 542, 542, 542, 542, 542, 542, 542, 542, 542, 542], 
[412, 412, 412, 412, 412, 412, 412, 412, 412, 412, 542, 542, 542, 542, 542, 542, 542, 542, 542, 542], 
[1057, 1065, 1065, 1065, 1065, 1065, 1065, 1065, 1065, 1942, 542, 542, 542, 542, 542, 542, 542, 542, 542, 542], 
[1057, 1048, 1048, 1048, 1048, 1048, 1048, 1048, 1048, 1048, 542, 542, 542, 542, 542, 542, 542, 542, 542, 542], 
[1057, 1048, 1048, 1048, 1048, 1048, 1048, 1048, 1048, 1048, 542, 542, 542, 542, 542, 542, 542, 542, 542, 542], 
[1057, 1048, 1048, 1048, 1048, 1048, 1048, 1048, 1048, 1048, 542, 542, 542, 542, 542, 542, 542, 542, 542, 542], 
[1057, 1048, 1048, 1048, 1048, 1048, 1048, 1048, 1048, 1048, 542, 542, 542, 542, 542, 542, 542, 542, 542, 542], 
[1057, 1048, 1048, 1048, 1048, 1048, 1048, 1048, 1048, 1048, 542, 542, 542, 542, 542, 542, 542, 542, 542, 542], 
[542, 542, 542, 542, 542, 542, 542, 542, 542, 542, 542, 542, 542, 542, 542, 542, 542, 542, 542, 542], 
[542, 542, 542, 542, 542, 542, 542, 542, 542, 542, 542, 542, 542, 542, 542, 542, 542, 542, 542, 542], 
[542, 542, 542, 542, 542, 542, 542, 542, 542, 542, 542, 542, 542, 542, 542, 542, 542, 542, 542, 542], 
[542, 542, 542, 542, 542, 542, 542, 542, 542, 542, 542, 542, 542, 542, 542, 542, 542, 542, 542, 542], 
[542, 542, 542, 542, 542, 542, 542, 542, 542, 542, 542, 542, 542, 542, 542, 542, 542, 542, 542, 542], 
[542, 542, 542, 542, 542, 542, 542, 542, 542, 542, 542, 542, 542, 542, 542, 542, 542, 542, 542, 542], 
[542, 542, 542, 542, 542, 542, 542, 542, 542, 542, 542, 542, 542, 542, 542, 542, 542, 542, 542, 542]], 

[[0, 0, 1530, 1531, 0, 1712, 0, 0, 0, 0, 0, 0, 0, 0, 0, 0, 0, 0, 0, 0], 
[1569, 1570, 1538, 1539, 0, 1720, 0, 1908, 1909, 1910, 0, 0, 0, 0, 0, 0, 0, 0, 0, 0], 
[1577, 1578, 1546, 1547, 0, 1728, 0, 1940, 1941, 1911, 0, 0, 0, 0, 0, 0, 0, 0, 0, 0], 
[0, 1168, 1169, 1169, 1169, 1169, 1170, 0, 1662, 1919, 0, 0, 0, 0, 0, 0, 0, 0, 0, 0], 
[0, 1176, 1177, 1177, 1177, 1177, 1178, 0, 0, 0, 0, 0, 0, 0, 0, 0, 0, 0, 0, 0], 
[0, 1176, 1177, 1177, 1177, 1177, 1178, 0, 0, 0, 0, 0, 0, 0, 0, 0, 0, 0, 0, 0], 
[1770, 1184, 1185, 1185, 1185, 1185, 1186, 0, 0, 1770, 0, 0, 0, 0, 0, 0, 0, 0, 0, 0], 
[1778, 0, 0, 0, 0, 1245, 1246, 1247, 0, 1778, 0, 0, 0, 0, 0, 0, 0, 0, 0, 0], 
[0, 0, 0, 0, 0, 1253, 1254, 1255, 0, 0, 0, 0, 0, 0, 0, 0, 0, 0, 0, 0], 
[0, 0, 0, 0, 0, 0, 0, 0, 0, 0, 0, 0, 0, 0, 0, 0, 0, 0, 0, 0], 
[0, 0, 0, 0, 0, 0, 0, 0, 0, 0, 0, 0, 0, 0, 0, 0, 0, 0, 0, 0], 
[0, 0, 0, 0, 0, 0, 0, 0, 0, 0, 0, 0, 0, 0, 0, 0, 0, 0, 0, 0], 
[0, 0, 0, 0, 0, 0, 0, 0, 0, 0, 0, 0, 0, 0, 0, 0, 0, 0, 0, 0], 
[0, 0, 0, 0, 0, 0, 0, 0, 0, 0, 0, 0, 0, 0, 0, 0, 0, 0, 0, 0], 
[0, 0, 0, 0, 0, 0, 0, 0, 0, 0, 0, 0, 0, 0, 0, 0, 0, 0, 0, 0]], 

[[0, 0, 0, 0, 0, 0, 0, 0, 0, 0, 0, 0, 0, 0, 0, 0, 0, 0, 0, 0], 
[0, 0, 0, 0, 0, 0, 0, 1895, 0, 1894, 0, 0, 0, 0, 0, 0, 0, 0, 0, 0], 
[0, 0, 0, 0, 0, 0, 1732, 0, 0, 1902, 0, 0, 0, 0, 0, 0, 0, 0, 0, 0], 
[0, 0, 0, 0, 0, 0, 0, 0, 0, 0, 0, 0, 0, 0, 0, 0, 0, 0, 0, 0], 
[0, 0, 1674, 2083, 2085, 1675, 0, 0, 0, 1732, 0, 0, 0, 0, 0, 0, 0, 0, 0, 0], 
[0, 0, 1674, 2091, 2093, 1675, 0, 0, 0, 0, 0, 0, 0, 0, 0, 0, 0, 0, 0, 0], 
[0, 0, 0, 0, 0, 0, 0, 0, 0, 0, 0, 0, 0, 0, 0, 0, 0, 0, 0, 0], 
[0, 0, 0, 0, 0, 0, 0, 0, 0, 0, 0, 0, 0, 0, 0, 0, 0, 0, 0, 0], 
[0, 0, 0, 0, 0, 0, 0, 0, 0, 0, 0, 0, 0, 0, 0, 0, 0, 0, 0, 0], 
[0, 0, 0, 0, 0, 0, 0, 0, 0, 0, 0, 0, 0, 0, 0, 0, 0, 0, 0, 0], 
[0, 0, 0, 0, 0, 0, 0, 0, 0, 0, 0, 0, 0, 0, 0, 0, 0, 0, 0, 0], 
[0, 0, 0, 0, 0, 0, 0, 0, 0, 0, 0, 0, 0, 0, 0, 0, 0, 0, 0, 0], 
[0, 0, 0, 0, 0, 0, 0, 0, 0, 0, 0, 0, 0, 0, 0, 0, 0, 0, 0, 0], 
[0, 0, 0, 0, 0, 0, 0, 0, 0, 0, 0, 0, 0, 0, 0, 0, 0, 0, 0, 0], 
[0, 0, 0, 0, 0, 0, 0, 0, 0, 0, 0, 0, 0, 0, 0, 0, 0, 0, 0, 0]]]
}
}
