{
	"Map": {
		"id": 11,
		"map_display_x": 0,
		"map_display_y": 0,
		"width": 20,
		"height": 15,
		"xsize": 20,
		"ysize": 15,
		"zsize": 3,
		"Name" : "Pokémon Institute",
		"Parent" : "Cedolan City",
		"Tileset" : "Interior general",
		"BattleBack" : "",
		"Autoplay_bgm" : true,
		"BGM" : "Lab",
		"Autoplay_bgs" : false,
		"BGS" : "",
		"Encounter_list" : [],
		"Encounter_step" : 30,
		"table": [[[520, 521, 521, 521, 521, 521, 521, 521, 521, 521, 521, 521, 521, 521, 523, 542, 542, 542, 542, 542], 
[528, 529, 529, 529, 529, 529, 529, 529, 529, 529, 529, 529, 529, 529, 531, 542, 542, 542, 542, 542], 
[593, 593, 617, 617, 617, 617, 617, 617, 617, 617, 617, 617, 593, 593, 618, 542, 542, 542, 542, 542], 
[593, 584, 584, 584, 584, 584, 584, 584, 584, 584, 584, 584, 584, 584, 584, 542, 542, 542, 542, 542], 
[593, 584, 584, 584, 584, 584, 584, 584, 584, 584, 584, 584, 584, 584, 584, 542, 542, 542, 542, 542], 
[593, 584, 584, 584, 584, 584, 584, 584, 584, 584, 584, 584, 584, 584, 584, 542, 542, 542, 542, 542], 
[593, 584, 584, 584, 584, 584, 584, 584, 584, 584, 584, 584, 584, 584, 584, 542, 542, 542, 542, 542], 
[593, 584, 584, 584, 584, 584, 584, 584, 584, 584, 584, 584, 584, 584, 584, 542, 542, 542, 542, 542], 
[593, 584, 584, 584, 584, 584, 584, 584, 584, 584, 584, 584, 584, 584, 584, 542, 542, 542, 542, 542], 
[593, 584, 584, 584, 584, 584, 584, 584, 584, 584, 584, 584, 584, 584, 584, 542, 542, 542, 542, 542], 
[542, 542, 542, 542, 542, 542, 542, 542, 542, 542, 542, 542, 542, 542, 542, 542, 542, 542, 542, 542], 
[542, 542, 542, 542, 542, 542, 542, 542, 542, 542, 542, 542, 542, 542, 542, 542, 542, 542, 542, 542], 
[542, 542, 542, 542, 542, 542, 542, 542, 542, 542, 542, 542, 542, 542, 542, 542, 542, 542, 542, 542], 
[542, 542, 542, 542, 542, 542, 542, 542, 542, 542, 542, 542, 542, 542, 542, 542, 542, 542, 542, 542], 
[542, 542, 542, 542, 542, 542, 542, 542, 542, 542, 542, 542, 542, 542, 542, 542, 542, 542, 542, 542]], 

[[520, 1693, 0, 1789, 1790, 1791, 1789, 1790, 1791, 1789, 1790, 1788, 1784, 1785, 523, 0, 0, 0, 0, 0], 
[528, 1701, 0, 1797, 1798, 1799, 1797, 1798, 1799, 1797, 1798, 1796, 1792, 1793, 531, 0, 0, 0, 0, 0], 
[536, 1709, 0, 1805, 1806, 1807, 1805, 1806, 1807, 1805, 1806, 1804, 1800, 1801, 539, 0, 0, 0, 0, 0], 
[1744, 0, 1924, 1925, 1926, 0, 0, 0, 0, 0, 0, 0, 0, 1744, 1744, 0, 0, 0, 0, 0], 
[1744, 0, 1916, 1917, 1918, 0, 0, 1907, 1907, 0, 0, 1924, 1925, 1926, 0, 0, 0, 0, 0, 0], 
[0, 0, 0, 1662, 0, 0, 1662, 1931, 1931, 1662, 0, 1932, 1933, 1934, 1662, 0, 0, 0, 0, 0], 
[0, 0, 1924, 1925, 1926, 0, 1662, 1931, 1931, 1662, 0, 1932, 1933, 1934, 0, 0, 0, 0, 0, 0], 
[0, 0, 1916, 1917, 1918, 0, 0, 1939, 1939, 0, 0, 1916, 1917, 1918, 1662, 0, 0, 0, 0, 0], 
[0, 0, 0, 1662, 0, 0, 0, 0, 0, 0, 0, 0, 0, 0, 0, 0, 0, 0, 0, 0], 
[0, 0, 0, 0, 0, 0, 1245, 1246, 1247, 0, 0, 0, 0, 0, 0, 0, 0, 0, 0, 0], 
[0, 0, 0, 0, 0, 0, 1253, 1254, 1255, 0, 0, 0, 0, 0, 0, 0, 0, 0, 0, 0], 
[0, 0, 0, 0, 0, 0, 0, 0, 0, 0, 0, 0, 0, 0, 0, 0, 0, 0, 0, 0], 
[0, 0, 0, 0, 0, 0, 0, 0, 0, 0, 0, 0, 0, 0, 0, 0, 0, 0, 0, 0], 
[0, 0, 0, 0, 0, 0, 0, 0, 0, 0, 0, 0, 0, 0, 0, 0, 0, 0, 0, 0], 
[0, 0, 0, 0, 0, 0, 0, 0, 0, 0, 0, 0, 0, 0, 0, 0, 0, 0, 0, 0]], 

[[0, 0, 0, 0, 0, 0, 0, 0, 0, 0, 0, 0, 0, 0, 0, 0, 0, 0, 0, 0], 
[0, 0, 0, 0, 0, 0, 0, 0, 0, 0, 0, 0, 0, 0, 0, 0, 0, 0, 0, 0], 
[0, 0, 0, 0, 0, 0, 0, 0, 0, 0, 0, 0, 0, 0, 0, 0, 0, 0, 0, 0], 
[0, 0, 1856, 1857, 1860, 0, 0, 0, 0, 0, 0, 0, 0, 0, 0, 0, 0, 0, 0, 0], 
[0, 0, 1864, 1865, 1868, 0, 0, 1872, 0, 0, 0, 0, 0, 0, 0, 0, 0, 0, 0, 0], 
[0, 0, 0, 0, 0, 0, 0, 1880, 1875, 0, 0, 0, 1724, 0, 0, 0, 0, 0, 0, 0], 
[0, 0, 1856, 1857, 1860, 0, 0, 1871, 1883, 0, 0, 0, 0, 1732, 0, 0, 0, 0, 0, 0], 
[0, 0, 1864, 1865, 1868, 0, 0, 0, 0, 0, 0, 0, 0, 0, 0, 0, 0, 0, 0, 0], 
[0, 0, 0, 0, 0, 0, 0, 0, 0, 0, 0, 0, 0, 0, 0, 0, 0, 0, 0, 0], 
[0, 0, 0, 0, 0, 0, 0, 0, 0, 0, 0, 0, 0, 0, 0, 0, 0, 0, 0, 0], 
[0, 0, 0, 0, 0, 0, 0, 0, 0, 0, 0, 0, 0, 0, 0, 0, 0, 0, 0, 0], 
[0, 0, 0, 0, 0, 0, 0, 0, 0, 0, 0, 0, 0, 0, 0, 0, 0, 0, 0, 0], 
[0, 0, 0, 0, 0, 0, 0, 0, 0, 0, 0, 0, 0, 0, 0, 0, 0, 0, 0, 0], 
[0, 0, 0, 0, 0, 0, 0, 0, 0, 0, 0, 0, 0, 0, 0, 0, 0, 0, 0, 0], 
[0, 0, 0, 0, 0, 0, 0, 0, 0, 0, 0, 0, 0, 0, 0, 0, 0, 0, 0, 0]]]
}
}
