{
	"Map": {
		"id": 12,
		"map_display_x": 0,
		"map_display_y": 0,
		"width": 20,
		"height": 15,
		"xsize": 20,
		"ysize": 15,
		"zsize": 3,
		"Name" : "Cedolan City Condo",
		"Parent" : "Cedolan City",
		"Tileset" : "Interior general",
		"BattleBack" : "",
		"Autoplay_bgm" : true,
		"BGM" : "021-Field04",
		"Autoplay_bgs" : false,
		"BGS" : "",
		"Encounter_list" : [],
		"Encounter_step" : 30,
		"table": [[[558, 558, 558, 558, 558, 541, 542, 543, 558, 558, 558, 558, 558, 542, 542, 542, 542, 542, 542, 542], 
[566, 566, 566, 566, 566, 549, 542, 551, 566, 566, 566, 566, 566, 542, 542, 542, 542, 542, 542, 542], 
[673, 673, 673, 673, 673, 549, 542, 551, 673, 673, 673, 673, 673, 542, 542, 542, 542, 542, 542, 542], 
[673, 664, 664, 664, 664, 549, 542, 551, 664, 664, 664, 664, 664, 542, 542, 542, 542, 542, 542, 542], 
[673, 664, 664, 664, 667, 549, 542, 551, 664, 664, 664, 664, 667, 542, 542, 542, 542, 542, 542, 542], 
[673, 664, 664, 673, 674, 557, 558, 559, 664, 664, 664, 673, 674, 542, 542, 542, 542, 542, 542, 542], 
[673, 664, 673, 673, 674, 565, 566, 567, 664, 664, 673, 673, 674, 542, 542, 542, 542, 542, 542, 542], 
[673, 664, 689, 681, 682, 664, 664, 664, 664, 664, 689, 681, 682, 542, 542, 542, 542, 542, 542, 542], 
[673, 664, 664, 664, 664, 664, 664, 664, 664, 664, 664, 664, 664, 542, 542, 542, 542, 542, 542, 542], 
[673, 664, 664, 664, 664, 664, 664, 664, 664, 664, 664, 664, 664, 542, 542, 542, 542, 542, 542, 542], 
[542, 542, 542, 542, 542, 542, 542, 542, 542, 542, 542, 542, 542, 542, 542, 542, 542, 542, 542, 542], 
[542, 542, 542, 542, 542, 542, 542, 542, 542, 542, 542, 542, 542, 542, 542, 542, 542, 542, 542, 542], 
[542, 542, 542, 542, 542, 542, 542, 542, 542, 542, 542, 542, 542, 542, 542, 542, 542, 542, 542, 542], 
[542, 542, 542, 542, 542, 542, 542, 542, 542, 542, 542, 542, 542, 542, 542, 542, 542, 542, 542, 542], 
[542, 542, 542, 542, 542, 542, 542, 542, 542, 542, 542, 542, 542, 542, 542, 542, 542, 542, 542, 542]], 

[[1766, 1534, 1535, 1534, 1535, 0, 0, 0, 1766, 1441, 1442, 0, 1766, 0, 0, 0, 0, 0, 0, 0], 
[1774, 1542, 1543, 1542, 1543, 0, 0, 0, 1774, 1449, 1450, 0, 1774, 0, 0, 0, 0, 0, 0, 0], 
[1782, 1550, 1551, 1550, 1551, 0, 0, 0, 1782, 0, 0, 0, 1782, 0, 0, 0, 0, 0, 0, 0], 
[0, 1662, 2101, 1662, 0, 0, 0, 0, 0, 1662, 2101, 1662, 0, 0, 0, 0, 0, 0, 0, 0], 
[0, 2108, 2109, 2110, 0, 0, 0, 0, 0, 2108, 2109, 2110, 0, 0, 0, 0, 0, 0, 0, 0], 
[1662, 2116, 2117, 2118, 1662, 0, 1459, 0, 1662, 2116, 2117, 2118, 1662, 0, 0, 0, 0, 0, 0, 0], 
[0, 2124, 2125, 2126, 0, 0, 1467, 0, 0, 2124, 2125, 2126, 0, 0, 0, 0, 0, 0, 0, 0], 
[0, 1662, 0, 1662, 0, 0, 0, 0, 0, 1662, 0, 1662, 0, 0, 0, 0, 0, 0, 0, 0], 
[1771, 0, 0, 0, 0, 0, 0, 0, 0, 0, 0, 0, 1771, 0, 0, 0, 0, 0, 0, 0], 
[1779, 0, 0, 0, 0, 1245, 1246, 1247, 0, 0, 0, 0, 1779, 0, 0, 0, 0, 0, 0, 0], 
[0, 0, 0, 0, 0, 1253, 1254, 1255, 0, 0, 0, 0, 0, 0, 0, 0, 0, 0, 0, 0], 
[0, 0, 0, 0, 0, 0, 0, 0, 0, 0, 0, 0, 0, 0, 0, 0, 0, 0, 0, 0], 
[0, 0, 0, 0, 0, 0, 0, 0, 0, 0, 0, 0, 0, 0, 0, 0, 0, 0, 0, 0], 
[0, 0, 0, 0, 0, 0, 0, 0, 0, 0, 0, 0, 0, 0, 0, 0, 0, 0, 0, 0], 
[0, 0, 0, 0, 0, 0, 0, 0, 0, 0, 0, 0, 0, 0, 0, 0, 0, 0, 0, 0]], 

[[0, 0, 0, 0, 0, 0, 0, 0, 0, 0, 0, 0, 0, 0, 0, 0, 0, 0, 0, 0], 
[0, 0, 0, 0, 0, 0, 0, 0, 0, 0, 0, 0, 0, 0, 0, 0, 0, 0, 0, 0], 
[0, 0, 0, 0, 0, 0, 0, 0, 0, 0, 0, 0, 0, 0, 0, 0, 0, 0, 0, 0], 
[0, 2100, 0, 2102, 0, 0, 0, 0, 0, 2100, 0, 2102, 0, 0, 0, 0, 0, 0, 0, 0], 
[0, 0, 0, 0, 0, 0, 0, 0, 0, 0, 0, 0, 0, 0, 0, 0, 0, 0, 0, 0], 
[0, 0, 0, 0, 0, 0, 0, 0, 0, 0, 0, 0, 0, 0, 0, 0, 0, 0, 0, 0], 
[0, 0, 0, 0, 0, 0, 0, 0, 0, 0, 0, 0, 0, 0, 0, 0, 0, 0, 0, 0], 
[0, 0, 0, 0, 0, 0, 0, 0, 0, 0, 0, 0, 0, 0, 0, 0, 0, 0, 0, 0], 
[0, 0, 0, 0, 0, 0, 0, 0, 0, 0, 0, 0, 0, 0, 0, 0, 0, 0, 0, 0], 
[0, 0, 0, 0, 0, 0, 0, 0, 0, 0, 0, 0, 0, 0, 0, 0, 0, 0, 0, 0], 
[0, 0, 0, 0, 0, 0, 0, 0, 0, 0, 0, 0, 0, 0, 0, 0, 0, 0, 0, 0], 
[0, 0, 0, 0, 0, 0, 0, 0, 0, 0, 0, 0, 0, 0, 0, 0, 0, 0, 0, 0], 
[0, 0, 0, 0, 0, 0, 0, 0, 0, 0, 0, 0, 0, 0, 0, 0, 0, 0, 0, 0], 
[0, 0, 0, 0, 0, 0, 0, 0, 0, 0, 0, 0, 0, 0, 0, 0, 0, 0, 0, 0], 
[0, 0, 0, 0, 0, 0, 0, 0, 0, 0, 0, 0, 0, 0, 0, 0, 0, 0, 0, 0]]]
}
}
