{
	"Map": {
		"id": 13,
		"map_display_x": 0,
		"map_display_y": 0,
		"width": 20,
		"height": 32,
		"xsize": 20,
		"ysize": 32,
		"zsize": 3,
		"Name" : "Game Corner",
		"Parent" : "Cedolan City",
		"Tileset" : "Game Corner interior",
		"BattleBack" : "",
		"Autoplay_bgm" : true,
		"BGM" : "gym",
		"Autoplay_bgs" : false,
		"BGS" : "",
		"Encounter_list" : [],
		"Encounter_step" : 30,
		"table": [[[384, 384, 384, 384, 385, 386, 387, 384, 384, 384, 384, 384, 384, 385, 386, 387, 384, 384, 479, 479], 
[392, 392, 392, 392, 393, 394, 395, 392, 392, 392, 392, 392, 392, 393, 394, 395, 392, 392, 479, 479], 
[409, 409, 409, 409, 409, 409, 409, 409, 409, 409, 409, 409, 409, 409, 409, 409, 409, 409, 479, 479], 
[409, 409, 409, 409, 409, 409, 409, 410, 409, 409, 409, 410, 409, 409, 409, 409, 409, 410, 479, 479], 
[409, 425, 417, 417, 417, 417, 417, 418, 425, 417, 417, 418, 425, 417, 417, 417, 417, 418, 479, 479], 
[409, 400, 400, 400, 400, 400, 400, 400, 400, 400, 400, 400, 400, 400, 400, 400, 400, 400, 479, 479], 
[409, 411, 400, 400, 400, 409, 409, 411, 400, 400, 400, 400, 400, 400, 400, 400, 400, 400, 479, 479], 
[409, 410, 400, 400, 400, 409, 409, 410, 400, 400, 400, 400, 400, 400, 400, 400, 400, 400, 479, 479], 
[409, 410, 400, 400, 400, 409, 409, 410, 400, 400, 409, 409, 409, 411, 400, 400, 400, 400, 479, 479], 
[409, 410, 400, 400, 400, 409, 409, 410, 400, 400, 409, 409, 409, 410, 400, 400, 400, 400, 479, 479], 
[409, 410, 400, 400, 400, 409, 409, 410, 400, 400, 409, 409, 409, 410, 400, 400, 400, 400, 479, 479], 
[409, 418, 400, 400, 400, 425, 417, 418, 400, 400, 425, 417, 417, 418, 400, 400, 400, 400, 479, 479], 
[409, 400, 400, 400, 400, 400, 400, 400, 400, 400, 400, 400, 400, 400, 400, 400, 400, 400, 479, 479], 
[409, 400, 400, 400, 400, 400, 400, 400, 400, 400, 400, 400, 400, 400, 400, 400, 400, 400, 479, 479], 
[479, 479, 479, 479, 479, 479, 479, 479, 479, 479, 479, 479, 479, 479, 479, 479, 479, 479, 479, 479], 
[479, 479, 479, 479, 479, 479, 479, 479, 479, 479, 479, 479, 479, 479, 479, 479, 479, 479, 479, 479], 
[479, 479, 479, 479, 479, 479, 479, 479, 479, 479, 479, 479, 479, 479, 479, 479, 479, 479, 479, 479], 
[479, 479, 479, 479, 479, 479, 479, 479, 479, 479, 479, 479, 479, 479, 479, 479, 479, 479, 479, 479], 
[479, 479, 479, 479, 479, 479, 479, 479, 479, 479, 479, 479, 479, 479, 479, 479, 479, 479, 479, 479], 
[479, 479, 479, 479, 479, 479, 479, 479, 479, 479, 479, 479, 479, 479, 479, 479, 479, 479, 479, 479], 
[479, 479, 479, 479, 479, 479, 479, 479, 479, 479, 479, 479, 479, 479, 479, 479, 479, 479, 479, 479], 
[384, 384, 384, 385, 386, 387, 384, 384, 384, 479, 479, 479, 479, 479, 479, 479, 479, 479, 479, 479], 
[392, 392, 392, 393, 394, 395, 392, 392, 392, 479, 479, 479, 479, 479, 479, 479, 479, 479, 479, 479], 
[409, 409, 409, 409, 409, 409, 409, 409, 409, 479, 479, 479, 479, 479, 479, 479, 479, 479, 479, 479], 
[409, 409, 409, 409, 409, 409, 409, 409, 409, 479, 479, 479, 479, 479, 479, 479, 479, 479, 479, 479], 
[409, 417, 417, 417, 417, 417, 417, 417, 417, 479, 479, 479, 479, 479, 479, 479, 479, 479, 479, 479], 
[409, 400, 400, 400, 400, 400, 400, 400, 400, 479, 479, 479, 479, 479, 479, 479, 479, 479, 479, 479], 
[409, 409, 411, 400, 400, 400, 400, 409, 409, 479, 479, 479, 479, 479, 479, 479, 479, 479, 479, 479], 
[409, 409, 410, 400, 400, 400, 400, 407, 409, 479, 479, 479, 479, 479, 479, 479, 479, 479, 479, 479], 
[409, 400, 400, 400, 400, 400, 400, 400, 400, 479, 479, 479, 479, 479, 479, 479, 479, 479, 479, 479], 
[479, 479, 479, 479, 479, 479, 479, 479, 479, 479, 479, 479, 479, 479, 479, 479, 479, 479, 479, 479], 
[479, 479, 479, 479, 479, 479, 479, 479, 479, 479, 479, 479, 479, 479, 479, 479, 479, 479, 479, 479]], 

[[0, 0, 488, 489, 0, 0, 0, 0, 0, 0, 0, 0, 0, 0, 0, 0, 0, 0, 0, 0], 
[499, 604, 496, 497, 0, 0, 604, 0, 604, 0, 604, 0, 604, 0, 0, 0, 604, 499, 0, 0], 
[507, 597, 504, 505, 571, 613, 599, 0, 597, 598, 599, 0, 597, 614, 598, 614, 599, 507, 0, 0], 
[0, 605, 623, 577, 579, 621, 607, 0, 605, 606, 607, 0, 605, 622, 606, 622, 607, 0, 0, 0], 
[0, 0, 0, 0, 0, 0, 0, 0, 0, 0, 0, 0, 0, 0, 0, 0, 0, 0, 0, 0], 
[513, 0, 0, 0, 0, 512, 513, 0, 0, 0, 0, 0, 0, 0, 0, 0, 0, 486, 0, 0], 
[521, 532, 0, 0, 524, 520, 521, 532, 0, 0, 0, 0, 0, 0, 0, 0, 0, 494, 0, 0], 
[521, 532, 0, 0, 524, 520, 521, 532, 0, 0, 525, 526, 527, 0, 0, 0, 0, 518, 0, 0], 
[521, 532, 0, 0, 524, 520, 521, 532, 0, 0, 533, 534, 535, 0, 0, 0, 0, 486, 0, 0], 
[521, 532, 0, 0, 524, 520, 521, 532, 0, 0, 544, 545, 546, 0, 0, 0, 0, 494, 0, 0], 
[529, 532, 0, 0, 524, 528, 529, 532, 0, 0, 552, 553, 554, 0, 0, 0, 0, 518, 0, 0], 
[0, 0, 0, 0, 0, 0, 0, 0, 0, 0, 0, 0, 0, 0, 0, 0, 0, 0, 0, 0], 
[499, 0, 0, 0, 0, 0, 0, 0, 0, 0, 0, 0, 0, 0, 0, 0, 0, 509, 0, 0], 
[507, 0, 0, 0, 0, 0, 0, 0, 468, 469, 470, 0, 0, 0, 0, 0, 0, 517, 0, 0], 
[0, 0, 0, 0, 0, 0, 0, 0, 476, 477, 478, 0, 0, 0, 0, 0, 0, 0, 0, 0], 
[0, 0, 0, 0, 0, 0, 0, 0, 0, 0, 0, 0, 0, 0, 0, 0, 0, 0, 0, 0], 
[0, 0, 0, 0, 0, 0, 0, 0, 0, 0, 0, 0, 0, 0, 0, 0, 0, 0, 0, 0], 
[0, 0, 0, 0, 0, 0, 0, 0, 0, 0, 0, 0, 0, 0, 0, 0, 0, 0, 0, 0], 
[0, 0, 0, 0, 0, 0, 0, 0, 0, 0, 0, 0, 0, 0, 0, 0, 0, 0, 0, 0], 
[0, 0, 0, 0, 0, 0, 0, 0, 0, 0, 0, 0, 0, 0, 0, 0, 0, 0, 0, 0], 
[0, 0, 0, 0, 0, 0, 0, 0, 0, 0, 0, 0, 0, 0, 0, 0, 0, 0, 0, 0], 
[0, 488, 489, 0, 0, 0, 488, 489, 0, 0, 0, 0, 0, 0, 0, 0, 0, 0, 0, 0], 
[604, 496, 497, 0, 0, 0, 496, 497, 604, 0, 0, 0, 0, 0, 0, 0, 0, 0, 0, 0], 
[597, 504, 505, 614, 598, 614, 504, 505, 599, 0, 0, 0, 0, 0, 0, 0, 0, 0, 0, 0], 
[605, 622, 606, 622, 606, 622, 606, 622, 607, 0, 0, 0, 0, 0, 0, 0, 0, 0, 0, 0], 
[0, 0, 0, 0, 0, 0, 0, 0, 0, 0, 0, 0, 0, 0, 0, 0, 0, 0, 0, 0], 
[480, 481, 0, 0, 0, 0, 0, 480, 481, 0, 0, 0, 0, 0, 0, 0, 0, 0, 0, 0], 
[496, 497, 0, 0, 0, 0, 0, 496, 497, 0, 0, 0, 0, 0, 0, 0, 0, 0, 0, 0], 
[504, 505, 0, 0, 0, 0, 0, 504, 505, 0, 0, 0, 0, 0, 0, 0, 0, 0, 0, 0], 
[0, 0, 0, 468, 469, 470, 0, 0, 0, 0, 0, 0, 0, 0, 0, 0, 0, 0, 0, 0], 
[0, 0, 0, 476, 477, 478, 0, 0, 0, 0, 0, 0, 0, 0, 0, 0, 0, 0, 0, 0], 
[0, 0, 0, 0, 0, 0, 0, 0, 0, 0, 0, 0, 0, 0, 0, 0, 0, 0, 0, 0]], 

[[0, 0, 0, 0, 0, 0, 0, 0, 0, 0, 0, 0, 0, 0, 0, 0, 0, 0, 0, 0], 
[0, 0, 0, 0, 0, 0, 0, 0, 0, 0, 0, 0, 0, 0, 0, 0, 0, 0, 0, 0], 
[0, 0, 615, 569, 0, 0, 0, 0, 0, 0, 0, 0, 0, 0, 0, 0, 0, 0, 0, 0], 
[0, 0, 0, 0, 0, 0, 0, 0, 0, 0, 0, 0, 0, 0, 0, 0, 0, 0, 0, 0], 
[0, 0, 0, 0, 0, 0, 0, 0, 0, 0, 0, 0, 0, 0, 0, 0, 0, 0, 0, 0], 
[0, 0, 0, 0, 0, 0, 0, 0, 0, 0, 0, 0, 0, 0, 0, 0, 0, 0, 0, 0], 
[0, 0, 0, 0, 0, 0, 0, 0, 0, 0, 0, 0, 0, 0, 0, 0, 0, 0, 0, 0], 
[0, 0, 0, 0, 0, 0, 0, 0, 0, 0, 0, 0, 0, 0, 0, 0, 0, 0, 0, 0], 
[0, 0, 0, 0, 0, 0, 0, 0, 0, 0, 536, 537, 538, 0, 0, 0, 0, 0, 0, 0], 
[0, 0, 0, 0, 0, 0, 0, 0, 0, 0, 0, 0, 0, 0, 0, 0, 0, 0, 0, 0], 
[0, 0, 0, 0, 0, 0, 0, 0, 0, 0, 0, 0, 0, 0, 0, 0, 0, 0, 0, 0], 
[0, 0, 0, 0, 0, 0, 0, 0, 0, 0, 0, 0, 0, 0, 0, 0, 0, 0, 0, 0], 
[0, 0, 0, 0, 0, 0, 0, 0, 0, 0, 0, 0, 0, 0, 0, 0, 0, 0, 0, 0], 
[0, 0, 0, 0, 0, 0, 0, 0, 0, 0, 0, 0, 0, 0, 0, 0, 0, 0, 0, 0], 
[0, 0, 0, 0, 0, 0, 0, 0, 0, 0, 0, 0, 0, 0, 0, 0, 0, 0, 0, 0], 
[0, 0, 0, 0, 0, 0, 0, 0, 0, 0, 0, 0, 0, 0, 0, 0, 0, 0, 0, 0], 
[0, 0, 0, 0, 0, 0, 0, 0, 0, 0, 0, 0, 0, 0, 0, 0, 0, 0, 0, 0], 
[0, 0, 0, 0, 0, 0, 0, 0, 0, 0, 0, 0, 0, 0, 0, 0, 0, 0, 0, 0], 
[0, 0, 0, 0, 0, 0, 0, 0, 0, 0, 0, 0, 0, 0, 0, 0, 0, 0, 0, 0], 
[0, 0, 0, 0, 0, 0, 0, 0, 0, 0, 0, 0, 0, 0, 0, 0, 0, 0, 0, 0], 
[0, 0, 0, 0, 0, 0, 0, 0, 0, 0, 0, 0, 0, 0, 0, 0, 0, 0, 0, 0], 
[0, 0, 0, 0, 0, 0, 0, 0, 0, 0, 0, 0, 0, 0, 0, 0, 0, 0, 0, 0], 
[0, 0, 0, 0, 0, 0, 0, 0, 0, 0, 0, 0, 0, 0, 0, 0, 0, 0, 0, 0], 
[0, 614, 598, 0, 0, 0, 598, 614, 0, 0, 0, 0, 0, 0, 0, 0, 0, 0, 0, 0], 
[0, 0, 0, 0, 0, 0, 0, 0, 0, 0, 0, 0, 0, 0, 0, 0, 0, 0, 0, 0], 
[0, 0, 0, 0, 0, 0, 0, 0, 0, 0, 0, 0, 0, 0, 0, 0, 0, 0, 0, 0], 
[0, 0, 0, 0, 0, 0, 0, 0, 0, 0, 0, 0, 0, 0, 0, 0, 0, 0, 0, 0], 
[0, 0, 0, 0, 0, 0, 0, 0, 0, 0, 0, 0, 0, 0, 0, 0, 0, 0, 0, 0], 
[0, 0, 0, 0, 0, 0, 0, 0, 0, 0, 0, 0, 0, 0, 0, 0, 0, 0, 0, 0], 
[0, 0, 0, 0, 0, 0, 0, 0, 0, 0, 0, 0, 0, 0, 0, 0, 0, 0, 0, 0], 
[0, 0, 0, 0, 0, 0, 0, 0, 0, 0, 0, 0, 0, 0, 0, 0, 0, 0, 0, 0], 
[0, 0, 0, 0, 0, 0, 0, 0, 0, 0, 0, 0, 0, 0, 0, 0, 0, 0, 0, 0]]]
}
}
