{
	"Map": {
		"id": 14,
		"map_display_x": 0,
		"map_display_y": 0,
		"width": 20,
		"height": 17,
		"xsize": 20,
		"ysize": 17,
		"zsize": 3,
		"Name" : "Cedolan Dept. 1F",
		"Parent" : "Cedolan City",
		"Tileset" : "Department store interior",
		"BattleBack" : "",
		"Autoplay_bgm" : true,
		"BGM" : "Poke Mart",
		"Autoplay_bgs" : false,
		"BGS" : "",
		"Encounter_list" : [],
		"Encounter_step" : 30,
		"table": [[[384, 385, 386, 386, 386, 387, 388, 389, 386, 386, 390, 384, 384, 384, 384, 384, 384, 384, 384, 384], 
[384, 393, 475, 476, 394, 395, 396, 397, 394, 394, 398, 384, 384, 384, 384, 384, 384, 384, 384, 384], 
[384, 393, 483, 484, 402, 403, 404, 405, 402, 402, 398, 384, 384, 384, 384, 384, 384, 384, 384, 384], 
[392, 401, 491, 492, 410, 410, 410, 410, 410, 410, 400, 392, 392, 384, 384, 384, 384, 384, 384, 384], 
[0, 0, 0, 0, 411, 411, 411, 411, 411, 411, 0, 0, 0, 384, 384, 384, 384, 384, 384, 384], 
[429, 429, 429, 429, 430, 420, 420, 420, 420, 420, 429, 458, 458, 384, 384, 384, 384, 384, 384, 384], 
[429, 420, 420, 420, 420, 420, 420, 420, 420, 420, 420, 429, 429, 384, 384, 384, 384, 384, 384, 384], 
[429, 420, 444, 445, 445, 445, 445, 445, 445, 445, 446, 420, 420, 384, 384, 384, 384, 384, 384, 384], 
[429, 420, 460, 453, 453, 453, 453, 453, 453, 453, 454, 420, 420, 384, 384, 384, 384, 384, 384, 384], 
[429, 420, 460, 453, 455, 471, 471, 471, 471, 461, 462, 420, 420, 384, 384, 384, 384, 384, 384, 384], 
[429, 420, 460, 453, 463, 453, 453, 453, 453, 461, 462, 420, 420, 384, 384, 384, 384, 384, 384, 384], 
[429, 420, 460, 461, 461, 461, 461, 461, 461, 461, 462, 420, 420, 384, 384, 384, 384, 384, 384, 384], 
[429, 420, 468, 469, 469, 469, 469, 469, 469, 469, 470, 420, 420, 384, 384, 384, 384, 384, 384, 384], 
[429, 420, 420, 420, 420, 420, 420, 420, 420, 420, 420, 420, 420, 384, 384, 384, 384, 384, 384, 384], 
[429, 420, 420, 420, 420, 420, 420, 420, 420, 420, 420, 420, 420, 384, 384, 384, 384, 384, 384, 384], 
[384, 384, 384, 384, 384, 384, 384, 384, 384, 384, 384, 384, 384, 384, 384, 384, 384, 384, 384, 384], 
[384, 384, 384, 384, 384, 384, 384, 384, 384, 384, 384, 384, 384, 384, 384, 384, 384, 384, 384, 384]], 

[[0, 0, 0, 0, 0, 0, 0, 0, 534, 0, 0, 0, 0, 0, 0, 0, 0, 0, 0, 0], 
[0, 0, 0, 0, 0, 0, 0, 0, 542, 0, 0, 0, 0, 0, 0, 0, 0, 0, 0, 0], 
[0, 0, 0, 0, 0, 0, 0, 0, 0, 0, 0, 0, 0, 0, 0, 0, 0, 0, 0, 0], 
[0, 0, 442, 443, 493, 0, 0, 0, 0, 0, 0, 0, 0, 0, 0, 0, 0, 0, 0, 0], 
[450, 450, 450, 451, 0, 0, 0, 0, 0, 0, 449, 450, 450, 0, 0, 0, 0, 0, 0, 0], 
[458, 458, 458, 459, 0, 0, 0, 0, 0, 0, 457, 560, 560, 0, 0, 0, 0, 0, 0, 0], 
[556, 0, 0, 0, 0, 0, 0, 0, 0, 0, 0, 568, 568, 0, 0, 0, 0, 0, 0, 0], 
[564, 0, 0, 513, 514, 514, 514, 514, 514, 515, 0, 0, 0, 0, 0, 0, 0, 0, 0, 0], 
[0, 0, 0, 521, 522, 522, 522, 522, 522, 523, 0, 0, 0, 0, 0, 0, 0, 0, 0, 0], 
[479, 0, 0, 528, 0, 0, 0, 0, 0, 528, 0, 0, 478, 0, 0, 0, 0, 0, 0, 0], 
[487, 0, 0, 529, 530, 530, 532, 530, 530, 531, 0, 0, 486, 0, 0, 0, 0, 0, 0, 0], 
[495, 0, 0, 537, 538, 538, 540, 538, 538, 539, 0, 0, 494, 0, 0, 0, 0, 0, 0, 0], 
[556, 0, 0, 0, 0, 0, 0, 0, 0, 0, 0, 0, 556, 0, 0, 0, 0, 0, 0, 0], 
[564, 0, 0, 0, 0, 0, 0, 0, 0, 0, 0, 0, 564, 0, 0, 0, 0, 0, 0, 0], 
[0, 576, 577, 578, 0, 0, 0, 0, 0, 576, 577, 578, 0, 0, 0, 0, 0, 0, 0, 0], 
[0, 584, 585, 586, 0, 0, 0, 0, 0, 584, 585, 586, 0, 0, 0, 0, 0, 0, 0, 0], 
[0, 0, 0, 0, 0, 0, 0, 0, 0, 0, 0, 0, 0, 0, 0, 0, 0, 0, 0, 0]], 

[[0, 0, 0, 0, 0, 0, 0, 0, 0, 0, 0, 0, 0, 0, 0, 0, 0, 0, 0, 0], 
[0, 0, 0, 0, 0, 0, 0, 0, 0, 0, 0, 0, 0, 0, 0, 0, 0, 0, 0, 0], 
[0, 0, 0, 0, 0, 0, 0, 0, 0, 0, 0, 0, 0, 0, 0, 0, 0, 0, 0, 0], 
[0, 0, 0, 0, 0, 0, 0, 0, 0, 0, 0, 0, 0, 0, 0, 0, 0, 0, 0, 0], 
[0, 0, 0, 0, 0, 0, 0, 0, 0, 0, 0, 544, 544, 0, 0, 0, 0, 0, 0, 0], 
[0, 0, 0, 0, 0, 0, 0, 0, 0, 0, 0, 552, 552, 0, 0, 0, 0, 0, 0, 0], 
[0, 0, 0, 0, 0, 0, 0, 0, 0, 0, 0, 0, 0, 0, 0, 0, 0, 0, 0, 0], 
[0, 0, 0, 0, 0, 0, 0, 0, 0, 0, 0, 0, 0, 0, 0, 0, 0, 0, 0, 0], 
[0, 0, 0, 0, 0, 0, 0, 0, 0, 0, 0, 0, 0, 0, 0, 0, 0, 0, 0, 0], 
[0, 0, 0, 0, 0, 0, 0, 0, 0, 0, 0, 0, 0, 0, 0, 0, 0, 0, 0, 0], 
[0, 0, 0, 0, 0, 0, 0, 0, 0, 0, 0, 0, 0, 0, 0, 0, 0, 0, 0, 0], 
[0, 0, 0, 0, 0, 0, 0, 0, 0, 0, 0, 0, 0, 0, 0, 0, 0, 0, 0, 0], 
[0, 0, 0, 0, 0, 0, 0, 0, 0, 0, 0, 0, 0, 0, 0, 0, 0, 0, 0, 0], 
[0, 0, 0, 0, 0, 0, 0, 0, 0, 0, 0, 0, 0, 0, 0, 0, 0, 0, 0, 0], 
[0, 0, 0, 0, 0, 0, 0, 0, 0, 0, 0, 0, 0, 0, 0, 0, 0, 0, 0, 0], 
[0, 0, 0, 0, 0, 0, 0, 0, 0, 0, 0, 0, 0, 0, 0, 0, 0, 0, 0, 0], 
[0, 0, 0, 0, 0, 0, 0, 0, 0, 0, 0, 0, 0, 0, 0, 0, 0, 0, 0, 0]]]
}
}
