{
	"Map": {
		"id": 16,
		"map_display_x": 0,
		"map_display_y": 0,
		"width": 20,
		"height": 17,
		"xsize": 20,
		"ysize": 17,
		"zsize": 3,
		"Name" : "Cedolan Dept. 3F",
		"Parent" : "Cedolan Dept. 1F",
		"Tileset" : "Department store interior",
		"BattleBack" : "",
		"Autoplay_bgm" : true,
		"BGM" : "Poke Mart",
		"Autoplay_bgs" : false,
		"BGS" : "",
		"Encounter_list" : [],
		"Encounter_step" : 30,
		"table": [[[385, 386, 386, 386, 386, 387, 388, 389, 386, 386, 386, 386, 390, 384, 384, 384, 384, 384, 384, 384], 
[393, 475, 476, 394, 394, 395, 396, 397, 394, 394, 394, 394, 398, 384, 384, 384, 384, 384, 384, 384], 
[393, 483, 484, 402, 402, 403, 413, 405, 402, 402, 497, 498, 398, 384, 384, 384, 384, 384, 384, 384], 
[401, 491, 492, 410, 410, 410, 410, 410, 410, 410, 505, 506, 406, 384, 384, 384, 384, 384, 384, 384], 
[0, 0, 0, 411, 411, 411, 411, 411, 411, 411, 0, 0, 0, 384, 384, 384, 384, 384, 384, 384], 
[429, 429, 429, 430, 420, 420, 420, 420, 420, 420, 429, 458, 458, 384, 384, 384, 384, 384, 384, 384], 
[429, 420, 420, 420, 420, 420, 420, 420, 420, 420, 420, 429, 429, 384, 384, 384, 384, 384, 384, 384], 
[429, 420, 420, 420, 420, 420, 420, 420, 420, 420, 420, 420, 420, 384, 384, 384, 384, 384, 384, 384], 
[429, 429, 429, 429, 429, 429, 429, 422, 420, 420, 420, 420, 420, 384, 384, 384, 384, 384, 384, 384], 
[429, 437, 437, 437, 437, 437, 437, 438, 420, 431, 437, 437, 429, 384, 384, 384, 384, 384, 384, 384], 
[429, 420, 420, 420, 420, 420, 420, 420, 420, 430, 420, 420, 429, 384, 384, 384, 384, 384, 384, 384], 
[429, 429, 429, 429, 429, 429, 429, 422, 429, 429, 429, 429, 429, 384, 384, 384, 384, 384, 384, 384], 
[429, 437, 437, 437, 437, 437, 437, 438, 437, 437, 437, 437, 437, 384, 384, 384, 384, 384, 384, 384], 
[429, 420, 420, 420, 420, 420, 420, 420, 420, 420, 420, 420, 420, 384, 384, 384, 384, 384, 384, 384], 
[429, 420, 420, 420, 420, 420, 420, 420, 420, 420, 420, 420, 420, 384, 384, 384, 384, 384, 384, 384], 
[384, 384, 384, 384, 384, 384, 384, 384, 384, 384, 384, 384, 384, 384, 384, 384, 384, 384, 384, 384], 
[384, 384, 384, 384, 384, 384, 384, 384, 384, 384, 384, 384, 384, 384, 384, 384, 384, 384, 384, 384]], 

[[0, 0, 0, 0, 0, 0, 0, 0, 534, 0, 0, 0, 0, 0, 0, 0, 0, 0, 0, 0], 
[0, 0, 0, 0, 0, 0, 0, 0, 542, 0, 0, 0, 0, 0, 0, 0, 0, 0, 0, 0], 
[0, 0, 0, 0, 0, 0, 0, 0, 0, 0, 0, 0, 0, 0, 0, 0, 0, 0, 0, 0], 
[0, 442, 443, 493, 0, 0, 0, 0, 0, 504, 441, 442, 0, 0, 0, 0, 0, 0, 0, 0], 
[450, 450, 451, 0, 0, 0, 0, 0, 0, 0, 449, 450, 450, 0, 0, 0, 0, 0, 0, 0], 
[458, 458, 459, 0, 0, 0, 0, 0, 0, 0, 457, 560, 560, 0, 0, 0, 0, 0, 0, 0], 
[0, 0, 0, 0, 0, 0, 0, 0, 0, 0, 0, 568, 568, 0, 0, 0, 0, 0, 0, 0], 
[513, 530, 530, 530, 530, 530, 515, 0, 513, 514, 532, 514, 515, 0, 0, 0, 0, 0, 0, 0], 
[537, 538, 538, 538, 538, 538, 539, 0, 521, 522, 540, 522, 523, 0, 0, 0, 0, 0, 0, 0], 
[0, 569, 0, 0, 569, 0, 0, 0, 528, 0, 0, 0, 528, 0, 0, 0, 0, 0, 0, 0], 
[513, 530, 530, 530, 530, 530, 515, 0, 529, 530, 530, 530, 531, 0, 0, 0, 0, 0, 0, 0], 
[537, 538, 538, 538, 538, 538, 539, 0, 537, 538, 538, 538, 539, 0, 0, 0, 0, 0, 0, 0], 
[0, 569, 0, 0, 569, 0, 0, 0, 0, 0, 0, 0, 0, 0, 0, 0, 0, 0, 0, 0], 
[556, 0, 0, 0, 0, 0, 0, 0, 0, 0, 0, 0, 556, 0, 0, 0, 0, 0, 0, 0], 
[564, 0, 0, 0, 0, 0, 0, 0, 0, 0, 0, 0, 564, 0, 0, 0, 0, 0, 0, 0], 
[0, 0, 0, 0, 0, 0, 0, 0, 0, 0, 0, 0, 0, 0, 0, 0, 0, 0, 0, 0], 
[0, 0, 0, 0, 0, 0, 0, 0, 0, 0, 0, 0, 0, 0, 0, 0, 0, 0, 0, 0]], 

[[0, 0, 0, 0, 0, 0, 0, 0, 0, 0, 0, 0, 0, 0, 0, 0, 0, 0, 0, 0], 
[0, 0, 0, 0, 0, 0, 0, 0, 0, 0, 0, 0, 0, 0, 0, 0, 0, 0, 0, 0], 
[0, 0, 0, 0, 0, 0, 0, 0, 0, 0, 0, 0, 0, 0, 0, 0, 0, 0, 0, 0], 
[0, 0, 0, 0, 0, 0, 0, 0, 0, 0, 0, 0, 0, 0, 0, 0, 0, 0, 0, 0], 
[535, 0, 535, 0, 0, 0, 0, 0, 0, 0, 0, 545, 545, 0, 0, 0, 0, 0, 0, 0], 
[0, 0, 0, 0, 0, 0, 0, 0, 0, 0, 0, 553, 553, 0, 0, 0, 0, 0, 0, 0], 
[0, 0, 0, 0, 0, 0, 0, 0, 0, 0, 0, 0, 0, 0, 0, 0, 0, 0, 0, 0], 
[0, 546, 545, 0, 546, 545, 0, 0, 0, 0, 0, 0, 0, 0, 0, 0, 0, 0, 0, 0], 
[0, 554, 553, 0, 554, 553, 0, 0, 0, 0, 0, 0, 0, 0, 0, 0, 0, 0, 0, 0], 
[0, 0, 0, 0, 0, 0, 0, 0, 0, 0, 0, 0, 0, 0, 0, 0, 0, 0, 0, 0], 
[0, 547, 545, 0, 546, 545, 0, 0, 0, 0, 0, 0, 0, 0, 0, 0, 0, 0, 0, 0], 
[0, 555, 553, 0, 554, 553, 0, 0, 0, 0, 0, 0, 0, 0, 0, 0, 0, 0, 0, 0], 
[0, 0, 0, 0, 0, 0, 0, 0, 0, 0, 0, 0, 0, 0, 0, 0, 0, 0, 0, 0], 
[0, 0, 0, 0, 0, 0, 0, 0, 0, 0, 0, 0, 0, 0, 0, 0, 0, 0, 0, 0], 
[0, 0, 0, 0, 0, 0, 0, 0, 0, 0, 0, 0, 0, 0, 0, 0, 0, 0, 0, 0], 
[0, 0, 0, 0, 0, 0, 0, 0, 0, 0, 0, 0, 0, 0, 0, 0, 0, 0, 0, 0], 
[0, 0, 0, 0, 0, 0, 0, 0, 0, 0, 0, 0, 0, 0, 0, 0, 0, 0, 0, 0]]]
}
}
