{
	"Map": {
		"id": 17,
		"map_display_x": 0,
		"map_display_y": 0,
		"width": 20,
		"height": 17,
		"xsize": 20,
		"ysize": 17,
		"zsize": 3,
		"Name" : "Cedolan Dept. 4F",
		"Parent" : "Cedolan Dept. 1F",
		"Tileset" : "Department store interior",
		"BattleBack" : "",
		"Autoplay_bgm" : true,
		"BGM" : "Poke Mart",
		"Autoplay_bgs" : false,
		"BGS" : "",
		"Encounter_list" : [],
		"Encounter_step" : 30,
		"table": [[[385, 386, 386, 386, 386, 387, 388, 389, 386, 386, 386, 386, 390, 384, 384, 384, 384, 384, 384, 384], 
[393, 394, 394, 394, 394, 395, 396, 397, 394, 394, 473, 474, 398, 384, 384, 384, 384, 384, 384, 384], 
[393, 499, 500, 402, 402, 403, 414, 405, 402, 402, 481, 482, 398, 384, 384, 384, 384, 384, 384, 384], 
[401, 507, 508, 410, 410, 410, 410, 410, 410, 410, 489, 490, 406, 384, 384, 384, 384, 384, 384, 384], 
[0, 0, 0, 411, 411, 411, 411, 411, 411, 411, 0, 0, 0, 384, 384, 384, 384, 384, 384, 384], 
[429, 429, 429, 430, 420, 420, 420, 420, 420, 420, 429, 429, 429, 384, 384, 384, 384, 384, 384, 384], 
[429, 420, 420, 420, 420, 420, 420, 420, 420, 420, 437, 437, 437, 384, 384, 384, 384, 384, 384, 384], 
[429, 420, 420, 422, 420, 420, 420, 420, 422, 420, 420, 420, 422, 384, 384, 384, 384, 384, 384, 384], 
[429, 429, 429, 430, 420, 437, 437, 437, 438, 437, 437, 437, 438, 384, 384, 384, 384, 384, 384, 384], 
[429, 429, 429, 430, 420, 420, 420, 420, 422, 420, 420, 420, 422, 384, 384, 384, 384, 384, 384, 384], 
[429, 437, 437, 438, 420, 437, 437, 437, 438, 437, 437, 437, 438, 384, 384, 384, 384, 384, 384, 384], 
[429, 420, 420, 420, 420, 420, 420, 420, 420, 420, 420, 420, 420, 384, 384, 384, 384, 384, 384, 384], 
[429, 429, 429, 429, 429, 429, 429, 420, 422, 420, 420, 420, 420, 384, 384, 384, 384, 384, 384, 384], 
[429, 437, 437, 437, 437, 437, 437, 429, 430, 420, 420, 420, 420, 384, 384, 384, 384, 384, 384, 384], 
[429, 420, 420, 420, 420, 420, 420, 429, 430, 420, 420, 420, 420, 384, 384, 384, 384, 384, 384, 384], 
[384, 384, 384, 384, 384, 384, 384, 384, 384, 384, 384, 384, 384, 384, 384, 384, 384, 384, 384, 384], 
[384, 384, 384, 384, 384, 384, 384, 384, 384, 384, 384, 384, 384, 384, 384, 384, 384, 384, 384, 384]], 

[[0, 0, 0, 0, 534, 0, 0, 0, 0, 0, 0, 0, 0, 0, 0, 0, 0, 0, 0, 0], 
[0, 0, 0, 0, 542, 0, 0, 0, 0, 0, 0, 0, 0, 0, 0, 0, 0, 0, 0, 0], 
[0, 0, 0, 0, 0, 0, 0, 0, 0, 0, 0, 0, 0, 0, 0, 0, 0, 0, 0, 0], 
[0, 442, 443, 509, 0, 0, 0, 0, 0, 488, 441, 442, 0, 0, 0, 0, 0, 0, 0, 0], 
[450, 450, 451, 0, 0, 0, 0, 0, 0, 0, 449, 450, 450, 0, 0, 0, 0, 0, 0, 0], 
[458, 458, 459, 0, 0, 0, 0, 0, 0, 0, 457, 458, 458, 0, 0, 0, 0, 0, 0, 0], 
[0, 574, 575, 0, 0, 612, 614, 615, 0, 612, 614, 615, 0, 0, 0, 0, 0, 0, 0, 0], 
[0, 582, 583, 0, 0, 620, 622, 623, 0, 620, 622, 623, 0, 0, 0, 0, 0, 0, 0, 0], 
[0, 590, 591, 0, 0, 612, 614, 615, 0, 612, 614, 615, 0, 0, 0, 0, 0, 0, 0, 0], 
[0, 598, 599, 0, 0, 620, 622, 623, 0, 620, 622, 623, 0, 0, 0, 0, 0, 0, 0, 0], 
[0, 0, 0, 0, 0, 0, 0, 0, 0, 0, 0, 0, 0, 0, 0, 0, 0, 0, 0, 0], 
[513, 530, 530, 532, 530, 530, 530, 515, 0, 0, 0, 0, 0, 0, 0, 0, 0, 0, 0, 0], 
[537, 538, 538, 540, 538, 538, 538, 523, 0, 0, 0, 0, 478, 0, 0, 0, 0, 0, 0, 0], 
[0, 0, 0, 0, 0, 0, 0, 528, 0, 556, 556, 0, 486, 0, 0, 0, 0, 0, 0, 0], 
[0, 0, 0, 0, 0, 0, 0, 536, 0, 564, 564, 0, 494, 0, 0, 0, 0, 0, 0, 0], 
[0, 0, 0, 0, 0, 0, 0, 0, 0, 0, 0, 0, 0, 0, 0, 0, 0, 0, 0, 0], 
[0, 0, 0, 0, 0, 0, 0, 0, 0, 0, 0, 0, 0, 0, 0, 0, 0, 0, 0, 0]], 

[[0, 0, 0, 0, 0, 0, 0, 0, 0, 0, 0, 0, 0, 0, 0, 0, 0, 0, 0, 0], 
[0, 0, 0, 0, 0, 0, 0, 0, 0, 0, 0, 0, 0, 0, 0, 0, 0, 0, 0, 0], 
[0, 0, 0, 0, 0, 0, 0, 0, 0, 0, 0, 0, 0, 0, 0, 0, 0, 0, 0, 0], 
[0, 0, 0, 0, 0, 0, 0, 0, 0, 0, 0, 0, 0, 0, 0, 0, 0, 0, 0, 0], 
[0, 0, 0, 0, 0, 0, 0, 0, 0, 0, 587, 588, 589, 0, 0, 0, 0, 0, 0, 0], 
[0, 0, 0, 0, 0, 0, 0, 0, 0, 0, 595, 596, 597, 0, 0, 0, 0, 0, 0, 0], 
[0, 0, 0, 0, 0, 0, 0, 0, 0, 0, 0, 0, 0, 0, 0, 0, 0, 0, 0, 0], 
[0, 0, 0, 0, 0, 0, 0, 0, 0, 0, 0, 0, 0, 0, 0, 0, 0, 0, 0, 0], 
[0, 0, 0, 0, 0, 0, 0, 0, 0, 0, 0, 0, 0, 0, 0, 0, 0, 0, 0, 0], 
[0, 0, 0, 0, 0, 0, 0, 0, 0, 0, 0, 0, 0, 0, 0, 0, 0, 0, 0, 0], 
[0, 0, 0, 0, 0, 0, 0, 0, 0, 0, 0, 0, 0, 0, 0, 0, 0, 0, 0, 0], 
[0, 0, 0, 0, 0, 0, 0, 0, 0, 0, 0, 0, 0, 0, 0, 0, 0, 0, 0, 0], 
[0, 0, 0, 0, 0, 0, 0, 0, 0, 0, 0, 0, 0, 0, 0, 0, 0, 0, 0, 0], 
[0, 0, 0, 0, 0, 0, 0, 0, 0, 0, 0, 0, 0, 0, 0, 0, 0, 0, 0, 0], 
[0, 0, 0, 0, 0, 0, 0, 0, 0, 0, 0, 0, 0, 0, 0, 0, 0, 0, 0, 0], 
[0, 0, 0, 0, 0, 0, 0, 0, 0, 0, 0, 0, 0, 0, 0, 0, 0, 0, 0, 0], 
[0, 0, 0, 0, 0, 0, 0, 0, 0, 0, 0, 0, 0, 0, 0, 0, 0, 0, 0, 0]]]
}
}
