{
	"Map": {
		"id": 18,
		"map_display_x": 0,
		"map_display_y": 0,
		"width": 20,
		"height": 17,
		"xsize": 20,
		"ysize": 17,
		"zsize": 3,
		"Name" : "Cedolan Dept. 5F",
		"Parent" : "Cedolan Dept. 1F",
		"Tileset" : "Department store interior",
		"BattleBack" : "",
		"Autoplay_bgm" : true,
		"BGM" : "Poke Mart",
		"Autoplay_bgs" : false,
		"BGS" : "",
		"Encounter_list" : [],
		"Encounter_step" : 30,
		"table": [[[385, 386, 386, 386, 386, 387, 388, 389, 386, 386, 386, 386, 390, 384, 384, 384, 384, 384, 384, 384], 
[393, 475, 476, 394, 394, 395, 396, 397, 394, 394, 394, 394, 398, 384, 384, 384, 384, 384, 384, 384], 
[393, 483, 484, 402, 402, 403, 415, 405, 402, 402, 497, 498, 398, 384, 384, 384, 384, 384, 384, 384], 
[401, 491, 492, 410, 410, 410, 410, 410, 410, 410, 505, 506, 406, 384, 384, 384, 384, 384, 384, 384], 
[0, 0, 0, 411, 411, 411, 411, 411, 411, 411, 0, 0, 0, 384, 384, 384, 384, 384, 384, 384], 
[429, 429, 459, 430, 420, 420, 420, 420, 420, 420, 429, 429, 429, 384, 384, 384, 384, 384, 384, 384], 
[429, 420, 420, 430, 420, 420, 420, 420, 420, 420, 437, 437, 437, 384, 384, 384, 384, 384, 384, 384], 
[429, 420, 420, 430, 420, 420, 420, 420, 420, 420, 420, 420, 420, 384, 384, 384, 384, 384, 384, 384], 
[429, 420, 420, 430, 420, 420, 420, 420, 420, 422, 420, 420, 422, 384, 384, 384, 384, 384, 384, 384], 
[429, 437, 437, 438, 420, 420, 420, 429, 429, 430, 429, 429, 430, 384, 384, 384, 384, 384, 384, 384], 
[429, 420, 420, 420, 420, 420, 420, 437, 437, 438, 437, 437, 438, 384, 384, 384, 384, 384, 384, 384], 
[429, 420, 420, 422, 420, 420, 422, 420, 420, 420, 420, 420, 420, 384, 384, 384, 384, 384, 384, 384], 
[429, 420, 429, 430, 420, 429, 430, 420, 420, 422, 420, 420, 422, 384, 384, 384, 384, 384, 384, 384], 
[429, 420, 429, 430, 420, 429, 430, 429, 429, 430, 429, 429, 430, 384, 384, 384, 384, 384, 384, 384], 
[429, 437, 437, 438, 437, 437, 438, 437, 437, 438, 437, 437, 438, 384, 384, 384, 384, 384, 384, 384], 
[384, 384, 384, 384, 384, 384, 384, 384, 384, 384, 384, 384, 384, 384, 384, 384, 384, 384, 384, 384], 
[384, 384, 384, 384, 384, 384, 384, 384, 384, 384, 384, 384, 384, 384, 384, 384, 384, 384, 384, 384]], 

[[0, 0, 0, 0, 0, 0, 0, 0, 534, 0, 0, 0, 0, 0, 0, 0, 0, 0, 0, 0], 
[0, 0, 0, 0, 0, 0, 0, 0, 542, 0, 0, 0, 0, 0, 0, 0, 0, 0, 0, 0], 
[0, 0, 0, 0, 0, 0, 0, 0, 0, 0, 0, 0, 0, 0, 0, 0, 0, 0, 0, 0], 
[0, 442, 443, 493, 0, 0, 0, 0, 0, 504, 441, 442, 0, 0, 0, 0, 0, 0, 0, 0], 
[450, 450, 451, 0, 0, 0, 0, 0, 0, 0, 449, 450, 450, 0, 0, 0, 0, 0, 0, 0], 
[458, 458, 528, 0, 0, 0, 0, 0, 0, 0, 457, 458, 458, 0, 0, 0, 0, 0, 0, 0], 
[0, 0, 528, 0, 0, 0, 0, 0, 0, 0, 0, 0, 0, 0, 0, 0, 0, 0, 0, 0], 
[513, 532, 531, 0, 0, 0, 0, 603, 603, 0, 603, 603, 0, 0, 0, 0, 0, 0, 0, 0], 
[537, 540, 539, 0, 0, 0, 0, 611, 611, 0, 611, 611, 0, 0, 0, 0, 0, 0, 0, 0], 
[0, 0, 0, 0, 0, 0, 0, 619, 619, 0, 619, 619, 0, 0, 0, 0, 0, 0, 0, 0], 
[0, 574, 575, 0, 574, 575, 0, 0, 0, 0, 0, 0, 0, 0, 0, 0, 0, 0, 0, 0], 
[0, 582, 583, 0, 582, 583, 0, 603, 603, 0, 603, 603, 0, 0, 0, 0, 0, 0, 0, 0], 
[0, 590, 591, 0, 590, 591, 0, 611, 611, 0, 611, 611, 0, 0, 0, 0, 0, 0, 0, 0], 
[556, 598, 599, 0, 598, 599, 0, 619, 619, 0, 619, 619, 556, 0, 0, 0, 0, 0, 0, 0], 
[564, 0, 0, 0, 0, 0, 0, 0, 0, 0, 0, 0, 564, 0, 0, 0, 0, 0, 0, 0], 
[0, 0, 0, 0, 0, 0, 0, 0, 0, 0, 0, 0, 0, 0, 0, 0, 0, 0, 0, 0], 
[0, 0, 0, 0, 0, 0, 0, 0, 0, 0, 0, 0, 0, 0, 0, 0, 0, 0, 0, 0]], 

[[0, 0, 0, 0, 0, 0, 0, 0, 0, 0, 0, 0, 0, 0, 0, 0, 0, 0, 0, 0], 
[0, 0, 0, 0, 0, 0, 0, 0, 0, 0, 0, 0, 0, 0, 0, 0, 0, 0, 0, 0], 
[0, 0, 0, 0, 0, 0, 0, 0, 0, 0, 0, 0, 0, 0, 0, 0, 0, 0, 0, 0], 
[0, 0, 0, 0, 0, 0, 0, 0, 0, 0, 0, 0, 0, 0, 0, 0, 0, 0, 0, 0], 
[0, 0, 520, 0, 0, 0, 0, 0, 0, 0, 587, 588, 589, 0, 0, 0, 0, 0, 0, 0], 
[0, 0, 516, 0, 0, 0, 0, 0, 0, 0, 595, 596, 597, 0, 0, 0, 0, 0, 0, 0], 
[0, 0, 524, 0, 0, 0, 0, 0, 0, 0, 0, 0, 0, 0, 0, 0, 0, 0, 0, 0], 
[0, 0, 0, 0, 0, 0, 0, 0, 0, 0, 0, 0, 0, 0, 0, 0, 0, 0, 0, 0], 
[0, 0, 0, 0, 0, 0, 0, 0, 0, 0, 0, 0, 0, 0, 0, 0, 0, 0, 0, 0], 
[0, 0, 0, 0, 0, 0, 0, 0, 0, 0, 0, 0, 0, 0, 0, 0, 0, 0, 0, 0], 
[0, 0, 0, 0, 0, 0, 0, 0, 0, 0, 0, 0, 0, 0, 0, 0, 0, 0, 0, 0], 
[0, 0, 0, 0, 0, 0, 0, 0, 0, 0, 0, 0, 0, 0, 0, 0, 0, 0, 0, 0], 
[0, 0, 0, 0, 0, 0, 0, 0, 0, 0, 0, 0, 0, 0, 0, 0, 0, 0, 0, 0], 
[0, 0, 0, 0, 0, 0, 0, 0, 0, 0, 0, 0, 0, 0, 0, 0, 0, 0, 0, 0], 
[0, 0, 0, 0, 0, 0, 0, 0, 0, 0, 0, 0, 0, 0, 0, 0, 0, 0, 0, 0], 
[0, 0, 0, 0, 0, 0, 0, 0, 0, 0, 0, 0, 0, 0, 0, 0, 0, 0, 0, 0], 
[0, 0, 0, 0, 0, 0, 0, 0, 0, 0, 0, 0, 0, 0, 0, 0, 0, 0, 0, 0]]]
}
}
