{
	"Map": {
		"id": 23,
		"map_display_x": 0,
		"map_display_y": 0,
		"width": 41,
		"height": 41,
		"xsize": 41,
		"ysize": 41,
		"zsize": 3,
		"Name" : "Lerucean Town",
		"Parent" : "",
		"Tileset" : "Outside",
		"BattleBack" : "",
		"Autoplay_bgm" : true,
		"BGM" : "021-Field04",
		"Autoplay_bgs" : false,
		"BGS" : "",
		"Encounter_list" : [],
		"Encounter_step" : 30,
		"table": [[[800, 801, 800, 801, 800, 801, 800, 801, 800, 801, 800, 801, 800, 801, 800, 801, 800, 803, 389, 385, 385, 389, 802, 801, 800, 801, 800, 801, 800, 801, 800, 801, 800, 801, 800, 801, 800, 801, 800, 801, 800], 
[808, 809, 808, 809, 808, 809, 808, 809, 808, 809, 808, 809, 808, 809, 808, 809, 808, 811, 386, 388, 388, 386, 810, 809, 808, 809, 808, 809, 808, 809, 808, 809, 808, 809, 808, 809, 808, 809, 808, 809, 808], 
[800, 801, 800, 803, 818, 819, 818, 819, 818, 819, 818, 819, 818, 819, 818, 819, 818, 819, 389, 388, 387, 388, 802, 803, 818, 819, 818, 819, 818, 819, 818, 819, 818, 819, 802, 801, 800, 801, 800, 801, 800], 
[808, 809, 808, 811, 385, 386, 385, 385, 385, 385, 386, 386, 385, 385, 386, 388, 385, 386, 388, 385, 387, 385, 810, 811, 385, 385, 387, 385, 385, 385, 385, 385, 385, 385, 810, 809, 808, 809, 808, 809, 808], 
[800, 801, 800, 803, 386, 386, 389, 388, 385, 385, 389, 386, 385, 387, 385, 385, 389, 386, 389, 387, 386, 385, 802, 803, 387, 388, 389, 385, 388, 385, 1088, 1089, 1090, 388, 802, 801, 800, 801, 800, 801, 800], 
[808, 809, 808, 811, 385, 385, 385, 386, 385, 386, 386, 385, 386, 388, 385, 385, 387, 386, 386, 388, 387, 388, 810, 811, 385, 385, 387, 388, 387, 385, 1096, 1097, 1098, 389, 810, 809, 808, 809, 808, 809, 808], 
[800, 801, 800, 803, 386, 387, 385, 386, 386, 388, 388, 385, 386, 386, 385, 388, 386, 385, 387, 385, 388, 389, 802, 803, 389, 385, 389, 385, 387, 389, 1234, 1092, 1098, 388, 802, 801, 800, 801, 800, 801, 800], 
[808, 809, 808, 811, 389, 385, 385, 385, 385, 385, 385, 385, 386, 386, 387, 385, 385, 385, 388, 385, 386, 385, 810, 811, 388, 385, 387, 385, 387, 387, 385, 1096, 1098, 385, 810, 809, 808, 809, 808, 809, 808], 
[800, 801, 800, 803, 385, 537, 538, 538, 538, 538, 538, 538, 538, 538, 538, 538, 538, 538, 538, 538, 538, 539, 802, 803, 385, 385, 385, 385, 385, 388, 385, 1233, 1233, 385, 802, 801, 800, 801, 800, 801, 800], 
[808, 809, 808, 811, 387, 545, 546, 546, 546, 546, 546, 546, 546, 546, 546, 546, 546, 546, 546, 546, 546, 547, 810, 811, 810, 811, 388, 388, 385, 385, 385, 385, 810, 811, 810, 809, 808, 809, 808, 809, 808], 
[800, 801, 800, 803, 389, 545, 546, 540, 554, 554, 554, 554, 554, 554, 554, 554, 554, 554, 554, 542, 546, 547, 818, 819, 818, 819, 385, 385, 385, 385, 388, 385, 818, 819, 802, 801, 800, 801, 800, 801, 800], 
[808, 809, 808, 811, 386, 545, 546, 547, 385, 385, 385, 387, 387, 385, 388, 385, 387, 385, 385, 545, 546, 556, 538, 538, 538, 538, 538, 538, 538, 538, 538, 539, 388, 389, 810, 809, 808, 809, 808, 809, 808], 
[818, 819, 818, 819, 385, 545, 546, 547, 388, 385, 385, 387, 386, 386, 386, 385, 387, 386, 389, 545, 546, 546, 546, 546, 546, 546, 546, 546, 546, 546, 546, 547, 388, 385, 802, 801, 800, 801, 800, 801, 800], 
[538, 538, 538, 538, 538, 558, 546, 547, 386, 386, 386, 388, 388, 388, 388, 387, 385, 385, 386, 545, 546, 540, 554, 554, 554, 554, 554, 554, 554, 554, 554, 555, 387, 388, 810, 809, 808, 809, 808, 809, 808], 
[546, 546, 546, 546, 546, 546, 546, 547, 387, 386, 386, 385, 387, 388, 387, 385, 386, 386, 387, 545, 546, 547, 385, 389, 386, 385, 389, 387, 387, 389, 385, 385, 386, 389, 802, 801, 800, 801, 800, 801, 800], 
[554, 554, 554, 554, 554, 542, 546, 547, 388, 386, 387, 385, 388, 385, 385, 387, 388, 386, 388, 545, 546, 547, 388, 388, 387, 385, 385, 388, 385, 388, 387, 389, 286, 385, 810, 809, 808, 809, 808, 809, 808], 
[386, 386, 387, 386, 388, 545, 546, 556, 538, 538, 538, 538, 538, 538, 538, 538, 538, 538, 538, 558, 546, 547, 387, 389, 385, 385, 385, 385, 387, 387, 385, 286, 388, 385, 802, 801, 800, 803, 818, 819, 818], 
[810, 811, 810, 811, 389, 545, 546, 546, 546, 546, 546, 546, 546, 546, 546, 546, 546, 546, 546, 546, 546, 547, 389, 387, 387, 386, 389, 385, 386, 387, 385, 387, 286, 389, 810, 809, 808, 811, 386, 386, 385], 
[800, 801, 800, 803, 386, 545, 546, 540, 554, 554, 554, 554, 554, 554, 554, 554, 554, 554, 554, 542, 546, 547, 386, 385, 386, 387, 387, 385, 387, 385, 388, 286, 388, 385, 818, 819, 818, 819, 388, 283, 273], 
[808, 809, 808, 811, 388, 545, 546, 547, 385, 385, 425, 426, 426, 426, 426, 427, 388, 385, 286, 545, 546, 547, 388, 385, 389, 388, 387, 385, 388, 389, 388, 388, 385, 385, 387, 386, 385, 387, 385, 386, 387], 
[800, 801, 800, 803, 387, 545, 546, 547, 389, 386, 433, 434, 434, 434, 434, 435, 387, 385, 386, 545, 546, 556, 538, 538, 538, 538, 538, 538, 538, 538, 538, 538, 538, 539, 387, 386, 385, 386, 387, 387, 385], 
[808, 809, 808, 811, 389, 545, 546, 547, 385, 386, 441, 442, 442, 442, 442, 443, 385, 385, 389, 545, 546, 546, 546, 546, 546, 546, 546, 546, 546, 546, 546, 546, 546, 547, 385, 387, 386, 388, 387, 389, 389], 
[800, 801, 800, 803, 387, 545, 546, 547, 388, 385, 385, 386, 385, 389, 386, 385, 385, 386, 385, 553, 554, 554, 554, 554, 554, 554, 554, 554, 554, 554, 554, 554, 554, 555, 385, 385, 385, 385, 385, 387, 386], 
[808, 809, 808, 811, 388, 545, 546, 547, 387, 385, 385, 385, 387, 387, 385, 386, 388, 385, 385, 385, 389, 386, 386, 385, 387, 385, 388, 385, 388, 385, 385, 387, 389, 387, 810, 811, 810, 811, 386, 283, 273], 
[800, 801, 800, 803, 389, 545, 546, 547, 386, 385, 385, 385, 389, 388, 385, 387, 385, 385, 282, 385, 388, 387, 388, 388, 386, 389, 387, 387, 387, 385, 385, 386, 388, 385, 802, 801, 800, 803, 388, 385, 387], 
[808, 809, 808, 811, 386, 545, 546, 547, 388, 389, 425, 426, 426, 426, 426, 427, 385, 385, 272, 385, 386, 385, 387, 385, 385, 386, 385, 387, 385, 385, 386, 386, 286, 386, 810, 809, 808, 811, 810, 811, 810], 
[800, 801, 800, 803, 389, 545, 546, 547, 386, 387, 433, 434, 434, 434, 434, 435, 386, 388, 284, 385, 386, 385, 387, 386, 386, 385, 385, 385, 385, 388, 385, 387, 386, 385, 802, 801, 800, 801, 800, 801, 800], 
[808, 809, 808, 811, 388, 545, 546, 547, 388, 385, 441, 442, 442, 442, 442, 443, 387, 385, 387, 388, 386, 385, 386, 387, 388, 385, 386, 385, 385, 385, 385, 385, 286, 388, 810, 809, 808, 809, 808, 809, 808], 
[800, 801, 800, 803, 386, 545, 546, 556, 538, 538, 538, 538, 538, 538, 538, 538, 538, 538, 538, 538, 538, 538, 538, 538, 538, 538, 538, 538, 538, 538, 538, 539, 386, 389, 802, 801, 800, 801, 800, 801, 800], 
[808, 809, 808, 811, 385, 545, 546, 546, 546, 546, 546, 546, 546, 546, 546, 546, 546, 546, 546, 546, 546, 546, 546, 546, 546, 546, 546, 546, 546, 546, 546, 547, 387, 388, 810, 809, 808, 809, 808, 809, 808], 
[800, 801, 800, 803, 389, 553, 554, 554, 554, 554, 554, 554, 554, 554, 554, 554, 554, 554, 554, 554, 554, 554, 554, 554, 554, 554, 554, 554, 554, 554, 554, 555, 387, 385, 802, 801, 800, 801, 800, 801, 800], 
[808, 809, 808, 811, 386, 385, 385, 385, 386, 385, 386, 387, 385, 387, 385, 385, 387, 386, 389, 388, 386, 387, 386, 386, 385, 387, 386, 386, 385, 386, 387, 386, 386, 389, 810, 809, 808, 809, 808, 809, 808], 
[800, 801, 800, 803, 388, 286, 386, 275, 285, 387, 386, 286, 385, 286, 385, 386, 388, 385, 385, 389, 385, 388, 387, 385, 286, 386, 385, 283, 262, 276, 387, 283, 277, 385, 802, 801, 800, 801, 800, 801, 800], 
[808, 809, 808, 811, 386, 385, 283, 279, 385, 286, 388, 387, 286, 385, 286, 387, 283, 285, 387, 283, 273, 285, 385, 286, 385, 286, 389, 386, 280, 270, 285, 386, 284, 387, 810, 809, 808, 809, 808, 809, 808], 
[800, 801, 800, 803, 388, 385, 386, 387, 385, 385, 385, 386, 386, 385, 385, 386, 385, 385, 385, 385, 385, 385, 387, 385, 385, 386, 386, 386, 386, 385, 385, 385, 386, 386, 802, 801, 800, 801, 800, 801, 800], 
[808, 809, 808, 811, 810, 811, 810, 811, 810, 811, 810, 811, 810, 811, 810, 811, 810, 811, 810, 811, 810, 811, 810, 811, 810, 811, 810, 811, 810, 811, 810, 811, 810, 811, 810, 809, 808, 809, 808, 809, 808], 
[800, 801, 800, 801, 800, 801, 800, 801, 800, 801, 800, 801, 800, 801, 800, 801, 800, 801, 800, 801, 800, 801, 800, 801, 800, 801, 800, 801, 800, 801, 800, 801, 800, 801, 800, 801, 800, 801, 800, 801, 800], 
[808, 809, 808, 809, 808, 809, 808, 809, 808, 809, 808, 809, 808, 809, 808, 809, 808, 809, 808, 809, 808, 809, 808, 809, 808, 809, 808, 809, 808, 809, 808, 809, 808, 809, 808, 809, 808, 809, 808, 809, 808], 
[800, 801, 800, 801, 800, 801, 800, 801, 800, 801, 800, 801, 800, 801, 800, 801, 800, 801, 800, 801, 800, 801, 800, 801, 800, 801, 800, 801, 800, 801, 800, 801, 800, 801, 800, 801, 800, 801, 800, 801, 800], 
[808, 809, 808, 809, 808, 809, 808, 809, 808, 809, 808, 809, 808, 809, 808, 809, 808, 809, 808, 809, 808, 809, 808, 809, 808, 809, 808, 809, 808, 809, 808, 809, 808, 809, 808, 809, 808, 809, 808, 809, 808], 
[800, 801, 800, 801, 800, 801, 800, 801, 800, 801, 800, 801, 800, 801, 800, 801, 800, 801, 800, 801, 800, 801, 800, 801, 800, 801, 800, 801, 800, 801, 800, 801, 800, 801, 800, 801, 800, 801, 800, 801, 800]], 

[[0, 0, 0, 0, 0, 0, 0, 0, 0, 0, 0, 0, 0, 0, 0, 0, 0, 0, 0, 0, 0, 0, 0, 0, 0, 0, 0, 0, 0, 0, 0, 0, 0, 0, 0, 0, 0, 0, 0, 0, 0], 
[0, 0, 0, 0, 0, 0, 0, 0, 0, 0, 0, 0, 0, 0, 0, 0, 0, 0, 0, 0, 0, 0, 0, 0, 0, 0, 0, 0, 0, 0, 0, 0, 0, 0, 0, 0, 0, 0, 0, 0, 0], 
[0, 0, 0, 0, 0, 0, 0, 0, 0, 0, 0, 0, 0, 0, 0, 0, 0, 0, 0, 0, 0, 0, 0, 0, 0, 0, 0, 0, 0, 0, 0, 0, 0, 0, 0, 0, 0, 0, 0, 0, 0], 
[0, 0, 0, 0, 1658, 1681, 1681, 1681, 1681, 1681, 1681, 1681, 1681, 1681, 1681, 1681, 1682, 859, 0, 0, 0, 0, 0, 0, 1662, 1681, 1681, 1681, 1681, 1681, 1681, 1681, 1681, 1663, 0, 0, 0, 0, 0, 0, 0], 
[0, 0, 0, 0, 1664, 1880, 1884, 1884, 1884, 1884, 1885, 1880, 1884, 1884, 1884, 1884, 1885, 859, 0, 0, 0, 0, 0, 0, 1665, 0, 0, 0, 0, 0, 1128, 1129, 1130, 1664, 0, 0, 0, 0, 0, 0, 0], 
[0, 0, 0, 0, 1664, 1888, 1889, 1890, 1891, 1892, 1893, 1888, 1889, 1890, 1891, 1892, 1893, 859, 0, 0, 0, 0, 0, 0, 1665, 0, 0, 0, 0, 0, 1136, 0, 1138, 1664, 0, 0, 0, 0, 0, 0, 0], 
[0, 0, 0, 0, 1664, 1896, 1900, 1900, 1900, 1900, 1901, 1896, 1900, 1900, 1900, 1900, 1901, 859, 0, 0, 0, 0, 0, 0, 1665, 0, 0, 0, 0, 0, 0, 1132, 1138, 1664, 0, 0, 0, 0, 0, 0, 0], 
[0, 0, 0, 0, 1664, 1904, 1912, 1913, 1914, 1915, 1909, 1904, 1912, 1913, 1914, 1915, 1909, 859, 0, 0, 0, 0, 0, 0, 1665, 0, 0, 0, 0, 0, 0, 1132, 1138, 1664, 0, 0, 0, 0, 0, 0, 0], 
[0, 0, 0, 0, 1664, 0, 0, 0, 0, 0, 0, 0, 0, 0, 0, 0, 0, 0, 0, 0, 0, 0, 0, 0, 1678, 1681, 1888, 1889, 1890, 1891, 1892, 1893, 1681, 1679, 0, 0, 0, 0, 0, 0, 0], 
[0, 0, 0, 0, 1664, 0, 0, 0, 0, 0, 0, 0, 0, 0, 0, 0, 0, 0, 0, 0, 0, 0, 0, 0, 0, 0, 1896, 1897, 1898, 1899, 1900, 1901, 0, 0, 0, 0, 0, 0, 0, 0, 0], 
[0, 0, 0, 0, 1664, 0, 0, 0, 0, 2992, 2993, 2994, 2995, 2996, 0, 0, 0, 0, 0, 0, 0, 0, 0, 0, 0, 0, 1904, 1905, 1906, 1917, 1915, 1909, 0, 0, 0, 0, 0, 0, 0, 0, 0], 
[0, 0, 0, 0, 1664, 0, 0, 0, 0, 3000, 3001, 3002, 3003, 3004, 3032, 3033, 3034, 3035, 0, 0, 0, 0, 0, 0, 0, 0, 0, 0, 0, 0, 0, 0, 0, 1657, 0, 0, 0, 0, 0, 0, 0], 
[0, 0, 0, 0, 1705, 0, 0, 0, 0, 3008, 3009, 3010, 3011, 3012, 3040, 3041, 3042, 3043, 0, 0, 0, 0, 0, 0, 0, 0, 0, 0, 0, 0, 0, 0, 0, 1665, 0, 0, 0, 0, 0, 0, 0], 
[0, 0, 0, 0, 0, 0, 0, 0, 0, 3016, 3017, 3018, 3019, 3020, 3048, 3049, 3050, 3051, 0, 0, 0, 0, 0, 0, 0, 0, 0, 0, 0, 0, 0, 0, 0, 1665, 0, 0, 0, 0, 0, 0, 0], 
[0, 0, 0, 0, 0, 0, 0, 0, 0, 3024, 3025, 3026, 3027, 3028, 3056, 3057, 3058, 3059, 0, 0, 0, 0, 0, 0, 0, 0, 0, 0, 0, 0, 0, 0, 0, 1665, 0, 0, 0, 0, 0, 0, 0], 
[0, 0, 0, 0, 0, 0, 0, 0, 0, 0, 0, 0, 0, 0, 0, 0, 0, 0, 0, 0, 0, 0, 0, 1784, 1785, 1786, 1787, 1788, 0, 0, 0, 0, 0, 1665, 0, 0, 0, 0, 0, 0, 0], 
[1681, 1681, 1681, 1681, 1663, 0, 0, 0, 0, 0, 0, 0, 0, 0, 0, 0, 0, 0, 0, 0, 0, 0, 0, 1792, 1793, 1794, 1795, 1796, 0, 0, 0, 0, 0, 1665, 0, 0, 0, 0, 0, 0, 0], 
[0, 0, 0, 0, 1664, 0, 0, 0, 0, 0, 0, 0, 0, 0, 0, 0, 0, 0, 0, 0, 0, 0, 0, 1800, 1801, 1802, 1803, 1804, 0, 0, 0, 0, 0, 1665, 0, 0, 0, 0, 1658, 1681, 1681], 
[0, 0, 0, 0, 1664, 0, 0, 0, 0, 0, 1343, 1387, 1388, 1388, 1389, 0, 0, 0, 0, 0, 0, 0, 1336, 1808, 1809, 1810, 1811, 1812, 0, 0, 0, 0, 0, 1673, 3353, 3353, 3353, 3353, 1672, 0, 0], 
[0, 0, 0, 0, 1664, 0, 0, 0, 0, 0, 1351, 1395, 1396, 1396, 1397, 1359, 0, 0, 0, 0, 0, 0, 0, 0, 0, 0, 0, 0, 0, 0, 0, 0, 3296, 3360, 3361, 3361, 3361, 3361, 3362, 3302, 0], 
[0, 0, 0, 0, 1664, 0, 0, 0, 0, 0, 1339, 1403, 0, 0, 1405, 1348, 1359, 0, 0, 0, 0, 0, 0, 0, 0, 0, 0, 0, 0, 0, 0, 0, 3304, 3305, 3306, 3306, 3306, 3306, 3309, 3310, 0], 
[0, 0, 0, 0, 1664, 0, 0, 0, 0, 0, 1341, 1349, 0, 0, 1339, 1349, 0, 0, 0, 0, 0, 0, 0, 0, 0, 0, 0, 0, 0, 0, 0, 0, 3312, 3344, 3345, 3345, 3345, 3345, 3346, 3318, 0], 
[0, 0, 0, 0, 1664, 0, 0, 0, 0, 0, 0, 0, 0, 0, 0, 0, 0, 0, 0, 0, 0, 0, 0, 0, 0, 0, 0, 0, 0, 0, 0, 0, 3320, 3384, 3385, 3385, 3385, 3385, 3386, 3326, 0], 
[0, 0, 0, 0, 1664, 0, 0, 0, 0, 0, 0, 0, 0, 0, 0, 0, 0, 0, 0, 0, 0, 0, 0, 0, 0, 0, 0, 0, 0, 0, 0, 0, 0, 1657, 0, 0, 0, 0, 1656, 0, 0], 
[0, 0, 0, 0, 1664, 0, 0, 0, 0, 0, 0, 1387, 1388, 1388, 1389, 1343, 0, 0, 0, 1880, 1884, 1884, 1884, 1884, 1885, 0, 1880, 1884, 1884, 1884, 1884, 1885, 0, 1665, 0, 0, 0, 0, 1674, 1681, 1681], 
[0, 0, 0, 0, 1664, 0, 0, 0, 0, 0, 1348, 1395, 1396, 1396, 1397, 1351, 0, 0, 0, 1888, 1889, 1890, 1891, 1892, 1893, 0, 1888, 1889, 1890, 1891, 1892, 1893, 0, 1665, 0, 0, 0, 0, 0, 0, 0], 
[0, 0, 0, 0, 1664, 0, 0, 0, 0, 1359, 1349, 1403, 0, 0, 1405, 1341, 1359, 0, 0, 1896, 1900, 1900, 1900, 1900, 1901, 0, 1896, 1900, 1900, 1900, 1900, 1901, 0, 1665, 0, 0, 0, 0, 0, 0, 0], 
[0, 0, 0, 0, 1664, 0, 0, 0, 0, 0, 1339, 1339, 0, 0, 1359, 1341, 0, 0, 0, 1904, 1912, 1913, 1914, 1915, 1909, 0, 1904, 1912, 1913, 1914, 1915, 1909, 0, 1665, 0, 0, 0, 0, 0, 0, 0], 
[0, 0, 0, 0, 1664, 0, 0, 0, 0, 0, 0, 0, 0, 0, 0, 0, 0, 0, 0, 0, 0, 0, 0, 0, 0, 0, 0, 0, 0, 0, 0, 0, 0, 1665, 0, 0, 0, 0, 0, 0, 0], 
[0, 0, 0, 0, 1664, 0, 0, 0, 0, 0, 0, 0, 0, 0, 0, 0, 0, 0, 0, 0, 0, 0, 0, 0, 0, 0, 0, 0, 0, 0, 0, 0, 0, 1665, 0, 0, 0, 0, 0, 0, 0], 
[0, 0, 0, 0, 1664, 0, 0, 0, 0, 0, 0, 0, 0, 0, 0, 0, 0, 0, 0, 0, 0, 0, 0, 0, 0, 0, 0, 0, 0, 0, 0, 0, 0, 1665, 0, 0, 0, 0, 0, 0, 0], 
[0, 0, 0, 0, 1664, 1069, 1070, 1070, 1070, 1070, 1070, 1070, 1070, 1070, 1071, 859, 0, 0, 0, 0, 0, 0, 859, 1069, 1070, 1070, 1070, 1070, 1070, 1070, 1070, 1070, 1071, 1665, 0, 0, 0, 0, 0, 0, 0], 
[0, 0, 0, 0, 1664, 0, 0, 0, 0, 0, 0, 0, 0, 0, 0, 0, 0, 0, 0, 0, 0, 0, 0, 0, 0, 0, 0, 0, 0, 0, 0, 0, 0, 1665, 0, 0, 0, 0, 0, 0, 0], 
[0, 0, 0, 0, 1664, 0, 0, 0, 0, 0, 0, 0, 0, 0, 0, 0, 0, 0, 0, 0, 0, 0, 0, 0, 0, 0, 0, 0, 0, 0, 0, 0, 0, 1665, 0, 0, 0, 0, 0, 0, 0], 
[0, 0, 0, 0, 1674, 1681, 1681, 1681, 1681, 1681, 1681, 1681, 1681, 1681, 1681, 1681, 1681, 1681, 1681, 1681, 1681, 1681, 1681, 1681, 1681, 1681, 1681, 1681, 1681, 1681, 1681, 1681, 1681, 1677, 0, 0, 0, 0, 0, 0, 0], 
[0, 0, 0, 0, 0, 0, 0, 0, 0, 0, 0, 0, 0, 0, 0, 0, 0, 0, 0, 0, 0, 0, 0, 0, 0, 0, 0, 0, 0, 0, 0, 0, 0, 0, 0, 0, 0, 0, 0, 0, 0], 
[0, 0, 0, 0, 0, 0, 0, 0, 0, 0, 0, 0, 0, 0, 0, 0, 0, 0, 0, 0, 0, 0, 0, 0, 0, 0, 0, 0, 0, 0, 0, 0, 0, 0, 0, 0, 0, 0, 0, 0, 0], 
[0, 0, 0, 0, 0, 0, 0, 0, 0, 0, 0, 0, 0, 0, 0, 0, 0, 0, 0, 0, 0, 0, 0, 0, 0, 0, 0, 0, 0, 0, 0, 0, 0, 0, 0, 0, 0, 0, 0, 0, 0], 
[0, 0, 0, 0, 0, 0, 0, 0, 0, 0, 0, 0, 0, 0, 0, 0, 0, 0, 0, 0, 0, 0, 0, 0, 0, 0, 0, 0, 0, 0, 0, 0, 0, 0, 0, 0, 0, 0, 0, 0, 0], 
[0, 0, 0, 0, 0, 0, 0, 0, 0, 0, 0, 0, 0, 0, 0, 0, 0, 0, 0, 0, 0, 0, 0, 0, 0, 0, 0, 0, 0, 0, 0, 0, 0, 0, 0, 0, 0, 0, 0, 0, 0], 
[0, 0, 0, 0, 0, 0, 0, 0, 0, 0, 0, 0, 0, 0, 0, 0, 0, 0, 0, 0, 0, 0, 0, 0, 0, 0, 0, 0, 0, 0, 0, 0, 0, 0, 0, 0, 0, 0, 0, 0, 0]], 

[[0, 0, 0, 0, 0, 0, 0, 0, 0, 0, 0, 0, 0, 0, 0, 0, 0, 0, 0, 0, 0, 0, 0, 0, 0, 0, 0, 0, 0, 0, 0, 0, 0, 0, 0, 0, 0, 0, 0, 0, 0], 
[0, 0, 0, 0, 0, 0, 0, 0, 0, 0, 0, 0, 0, 0, 0, 0, 0, 0, 0, 0, 0, 0, 0, 0, 0, 0, 0, 0, 0, 0, 0, 0, 0, 0, 0, 0, 0, 0, 0, 0, 0], 
[0, 0, 0, 0, 0, 0, 0, 0, 0, 0, 0, 0, 0, 0, 0, 0, 0, 0, 0, 0, 0, 0, 0, 0, 0, 0, 0, 0, 0, 0, 0, 0, 0, 0, 0, 0, 0, 0, 0, 0, 0], 
[0, 0, 0, 0, 0, 0, 0, 0, 0, 0, 0, 0, 0, 0, 0, 0, 0, 0, 0, 0, 0, 0, 0, 0, 0, 0, 0, 0, 0, 0, 0, 0, 0, 0, 0, 0, 0, 0, 0, 0, 0], 
[0, 0, 0, 0, 0, 0, 0, 0, 0, 0, 0, 0, 0, 0, 0, 0, 0, 0, 0, 0, 0, 0, 0, 0, 0, 0, 0, 0, 0, 0, 0, 0, 0, 0, 0, 0, 0, 0, 0, 0, 0], 
[0, 0, 0, 0, 0, 0, 0, 0, 0, 0, 0, 0, 0, 0, 0, 0, 0, 0, 0, 0, 0, 0, 0, 0, 0, 0, 0, 0, 0, 0, 0, 0, 0, 0, 0, 0, 0, 0, 0, 0, 0], 
[0, 0, 0, 0, 0, 0, 0, 0, 0, 0, 0, 0, 0, 0, 0, 0, 0, 0, 0, 0, 0, 0, 0, 0, 0, 0, 0, 0, 0, 0, 0, 0, 0, 0, 0, 0, 0, 0, 0, 0, 0], 
[0, 0, 0, 0, 0, 0, 0, 0, 0, 0, 0, 0, 0, 0, 0, 0, 0, 0, 0, 0, 0, 0, 0, 0, 0, 0, 1880, 1884, 1884, 1884, 1884, 1885, 0, 0, 0, 0, 0, 0, 0, 0, 0], 
[0, 0, 0, 0, 0, 0, 0, 0, 0, 0, 0, 0, 0, 0, 0, 0, 0, 0, 0, 0, 0, 0, 0, 0, 804, 805, 0, 0, 0, 0, 0, 0, 804, 805, 0, 0, 0, 0, 0, 0, 0], 
[0, 0, 0, 0, 0, 0, 0, 0, 0, 0, 0, 0, 0, 0, 0, 0, 0, 0, 0, 0, 0, 0, 0, 0, 0, 0, 0, 0, 0, 0, 0, 0, 0, 0, 0, 0, 0, 0, 0, 0, 0], 
[0, 0, 0, 0, 0, 0, 0, 0, 0, 0, 0, 0, 0, 0, 0, 0, 0, 0, 0, 0, 0, 0, 0, 0, 0, 0, 0, 0, 0, 0, 0, 0, 0, 0, 0, 0, 0, 0, 0, 0, 0], 
[0, 0, 0, 0, 0, 0, 0, 0, 0, 0, 0, 0, 0, 0, 0, 0, 0, 0, 0, 0, 0, 0, 0, 0, 0, 0, 0, 0, 0, 0, 0, 0, 0, 0, 0, 0, 0, 0, 0, 0, 0], 
[0, 0, 0, 0, 0, 0, 0, 0, 0, 0, 0, 0, 0, 0, 0, 0, 0, 0, 0, 0, 0, 0, 0, 0, 0, 0, 0, 0, 0, 0, 0, 0, 0, 0, 0, 0, 0, 0, 0, 0, 0], 
[0, 0, 0, 0, 0, 0, 0, 0, 0, 0, 0, 0, 0, 0, 0, 0, 0, 0, 0, 0, 0, 0, 0, 0, 0, 0, 0, 0, 0, 0, 0, 0, 0, 0, 0, 0, 0, 0, 0, 0, 0], 
[0, 0, 0, 0, 0, 0, 0, 0, 0, 0, 0, 0, 0, 0, 0, 0, 0, 0, 0, 0, 0, 0, 0, 0, 0, 0, 0, 0, 0, 0, 0, 0, 0, 0, 0, 0, 0, 0, 0, 0, 0], 
[0, 0, 0, 0, 0, 0, 0, 0, 0, 0, 0, 0, 0, 0, 0, 0, 0, 0, 0, 0, 0, 0, 0, 0, 0, 0, 0, 0, 0, 0, 0, 0, 0, 0, 0, 0, 0, 0, 0, 0, 0], 
[804, 805, 804, 805, 0, 0, 0, 0, 0, 0, 0, 0, 0, 0, 0, 0, 0, 0, 0, 0, 0, 0, 0, 0, 0, 0, 0, 0, 0, 0, 0, 0, 0, 0, 0, 0, 0, 0, 0, 0, 0], 
[0, 0, 0, 0, 0, 0, 0, 0, 0, 0, 0, 0, 0, 0, 0, 0, 0, 0, 0, 0, 0, 0, 0, 0, 0, 0, 0, 0, 0, 0, 0, 0, 0, 0, 0, 0, 0, 0, 0, 0, 0], 
[0, 0, 0, 0, 0, 0, 0, 0, 0, 0, 0, 0, 0, 0, 0, 0, 0, 0, 0, 0, 0, 0, 0, 0, 0, 1368, 1369, 1370, 0, 0, 0, 0, 0, 3352, 0, 0, 0, 0, 3354, 0, 0], 
[0, 0, 0, 0, 0, 0, 0, 0, 0, 0, 0, 0, 0, 0, 0, 0, 0, 0, 0, 0, 0, 0, 0, 0, 0, 1376, 1377, 1378, 0, 0, 0, 0, 0, 0, 0, 0, 0, 0, 0, 0, 0], 
[0, 0, 0, 0, 0, 0, 0, 0, 0, 0, 0, 0, 0, 0, 0, 0, 0, 0, 0, 0, 0, 0, 0, 0, 0, 0, 0, 0, 0, 0, 0, 0, 0, 0, 0, 0, 0, 0, 0, 0, 0], 
[0, 0, 0, 0, 0, 0, 0, 0, 0, 0, 0, 0, 0, 0, 0, 0, 0, 0, 0, 0, 0, 0, 0, 0, 0, 0, 0, 0, 0, 0, 0, 0, 0, 0, 0, 0, 0, 0, 0, 0, 0], 
[0, 0, 0, 0, 0, 0, 0, 0, 0, 0, 0, 0, 0, 0, 0, 0, 0, 0, 0, 0, 0, 0, 0, 0, 0, 0, 0, 0, 0, 0, 0, 0, 0, 0, 804, 805, 804, 805, 0, 0, 0], 
[0, 0, 0, 0, 0, 0, 0, 0, 0, 0, 0, 0, 0, 0, 0, 0, 0, 0, 0, 0, 0, 0, 0, 0, 0, 0, 0, 0, 0, 0, 0, 0, 0, 0, 0, 0, 0, 0, 0, 0, 0], 
[0, 0, 0, 0, 0, 0, 0, 0, 0, 0, 0, 0, 0, 0, 0, 0, 0, 0, 0, 0, 0, 0, 0, 0, 0, 0, 0, 0, 0, 0, 0, 0, 0, 0, 0, 0, 0, 0, 804, 805, 804], 
[0, 0, 0, 0, 0, 0, 0, 0, 0, 0, 0, 0, 0, 0, 0, 0, 0, 0, 0, 0, 0, 0, 0, 0, 0, 0, 0, 0, 0, 0, 0, 0, 0, 0, 0, 0, 0, 0, 0, 0, 0], 
[0, 0, 0, 0, 0, 0, 0, 0, 0, 0, 0, 0, 0, 0, 0, 0, 0, 0, 0, 0, 0, 0, 0, 0, 0, 0, 0, 0, 0, 0, 0, 0, 0, 0, 0, 0, 0, 0, 0, 0, 0], 
[0, 0, 0, 0, 0, 0, 0, 0, 0, 0, 0, 0, 0, 0, 0, 0, 0, 0, 0, 0, 0, 0, 0, 0, 0, 0, 0, 0, 0, 0, 0, 0, 0, 0, 0, 0, 0, 0, 0, 0, 0], 
[0, 0, 0, 0, 0, 0, 0, 0, 0, 0, 0, 0, 0, 0, 0, 0, 0, 0, 0, 0, 0, 0, 0, 0, 0, 0, 0, 0, 0, 0, 0, 0, 0, 0, 0, 0, 0, 0, 0, 0, 0], 
[0, 0, 0, 0, 0, 0, 0, 0, 0, 0, 0, 0, 0, 0, 0, 0, 0, 0, 0, 0, 0, 0, 0, 0, 0, 0, 0, 0, 0, 0, 0, 0, 0, 0, 0, 0, 0, 0, 0, 0, 0], 
[0, 0, 0, 0, 0, 0, 0, 0, 0, 0, 0, 0, 0, 0, 0, 0, 0, 0, 0, 0, 0, 0, 0, 0, 0, 0, 0, 0, 0, 0, 0, 0, 0, 0, 0, 0, 0, 0, 0, 0, 0], 
[0, 0, 0, 0, 0, 0, 0, 0, 0, 0, 0, 0, 0, 0, 0, 0, 0, 0, 0, 0, 0, 0, 0, 0, 0, 0, 0, 0, 0, 0, 0, 0, 0, 0, 0, 0, 0, 0, 0, 0, 0], 
[0, 0, 0, 0, 0, 0, 0, 0, 0, 0, 0, 0, 0, 0, 0, 0, 0, 0, 0, 0, 0, 0, 0, 0, 0, 0, 0, 0, 0, 0, 0, 0, 0, 0, 0, 0, 0, 0, 0, 0, 0], 
[0, 0, 0, 0, 0, 0, 0, 0, 0, 0, 0, 0, 0, 0, 0, 0, 0, 0, 0, 0, 0, 0, 0, 0, 0, 0, 0, 0, 0, 0, 0, 0, 0, 0, 0, 0, 0, 0, 0, 0, 0], 
[0, 0, 0, 0, 804, 805, 804, 805, 804, 805, 804, 805, 804, 805, 804, 805, 804, 805, 804, 805, 804, 805, 804, 805, 804, 805, 804, 805, 804, 805, 804, 805, 804, 805, 0, 0, 0, 0, 0, 0, 0], 
[0, 0, 0, 0, 0, 0, 0, 0, 0, 0, 0, 0, 0, 0, 0, 0, 0, 0, 0, 0, 0, 0, 0, 0, 0, 0, 0, 0, 0, 0, 0, 0, 0, 0, 0, 0, 0, 0, 0, 0, 0], 
[0, 0, 0, 0, 0, 0, 0, 0, 0, 0, 0, 0, 0, 0, 0, 0, 0, 0, 0, 0, 0, 0, 0, 0, 0, 0, 0, 0, 0, 0, 0, 0, 0, 0, 0, 0, 0, 0, 0, 0, 0], 
[0, 0, 0, 0, 0, 0, 0, 0, 0, 0, 0, 0, 0, 0, 0, 0, 0, 0, 0, 0, 0, 0, 0, 0, 0, 0, 0, 0, 0, 0, 0, 0, 0, 0, 0, 0, 0, 0, 0, 0, 0], 
[0, 0, 0, 0, 0, 0, 0, 0, 0, 0, 0, 0, 0, 0, 0, 0, 0, 0, 0, 0, 0, 0, 0, 0, 0, 0, 0, 0, 0, 0, 0, 0, 0, 0, 0, 0, 0, 0, 0, 0, 0], 
[0, 0, 0, 0, 0, 0, 0, 0, 0, 0, 0, 0, 0, 0, 0, 0, 0, 0, 0, 0, 0, 0, 0, 0, 0, 0, 0, 0, 0, 0, 0, 0, 0, 0, 0, 0, 0, 0, 0, 0, 0], 
[0, 0, 0, 0, 0, 0, 0, 0, 0, 0, 0, 0, 0, 0, 0, 0, 0, 0, 0, 0, 0, 0, 0, 0, 0, 0, 0, 0, 0, 0, 0, 0, 0, 0, 0, 0, 0, 0, 0, 0, 0]]]
}
}
