{
	"Map": {
		"id": 24,
		"map_display_x": 0,
		"map_display_y": 0,
		"width": 20,
		"height": 15,
		"xsize": 20,
		"ysize": 15,
		"zsize": 3,
		"Name" : "Lerucean Town Poké Center",
		"Parent" : "Lerucean Town",
		"Tileset" : "Poke Centre interior",
		"BattleBack" : "",
		"Autoplay_bgm" : true,
		"BGM" : "Poke Center",
		"Autoplay_bgs" : false,
		"BGS" : "",
		"Encounter_list" : [],
		"Encounter_step" : 30,
		"table": [[[384, 385, 385, 385, 385, 385, 385, 385, 385, 385, 385, 385, 385, 385, 386, 387, 387, 387, 387, 387], 
[392, 393, 393, 393, 393, 393, 393, 393, 393, 393, 393, 393, 393, 393, 394, 387, 387, 387, 387, 387], 
[400, 457, 457, 457, 457, 457, 457, 475, 465, 457, 457, 457, 475, 465, 402, 387, 387, 387, 387, 387], 
[457, 448, 448, 448, 457, 457, 457, 457, 457, 457, 457, 458, 448, 448, 472, 387, 387, 387, 387, 387], 
[457, 448, 448, 448, 473, 465, 465, 465, 465, 465, 465, 466, 448, 448, 448, 387, 387, 387, 387, 387], 
[457, 448, 448, 448, 448, 448, 485, 486, 487, 448, 448, 448, 448, 448, 448, 387, 387, 387, 387, 387], 
[457, 448, 448, 448, 451, 448, 493, 494, 495, 448, 448, 448, 448, 451, 448, 387, 387, 387, 387, 387], 
[457, 448, 457, 457, 458, 448, 501, 502, 503, 448, 448, 457, 457, 458, 448, 387, 387, 387, 387, 387], 
[457, 448, 473, 465, 466, 448, 448, 448, 448, 448, 448, 473, 465, 466, 448, 387, 387, 387, 387, 387], 
[387, 387, 387, 387, 387, 387, 387, 387, 387, 387, 387, 387, 387, 387, 387, 387, 387, 387, 387, 387], 
[387, 387, 387, 387, 387, 387, 387, 387, 387, 387, 387, 387, 387, 387, 387, 387, 387, 387, 387, 387], 
[387, 387, 387, 387, 387, 387, 387, 387, 387, 387, 387, 387, 387, 387, 387, 387, 387, 387, 387, 387], 
[387, 387, 387, 387, 387, 387, 387, 387, 387, 387, 387, 387, 387, 387, 387, 387, 387, 387, 387, 387], 
[387, 387, 387, 387, 387, 387, 387, 387, 387, 387, 387, 387, 387, 387, 387, 387, 387, 387, 387, 387], 
[387, 387, 387, 387, 387, 387, 387, 387, 387, 387, 387, 387, 387, 387, 387, 387, 387, 387, 387, 387]], 

[[0, 662, 636, 637, 0, 0, 0, 432, 433, 0, 0, 638, 434, 435, 0, 0, 0, 0, 0, 0], 
[0, 670, 644, 645, 568, 581, 582, 440, 441, 583, 568, 646, 442, 443, 0, 0, 0, 0, 0, 0], 
[0, 678, 652, 653, 585, 589, 590, 601, 570, 591, 587, 654, 0, 0, 0, 0, 0, 0, 0, 0], 
[0, 0, 0, 0, 593, 594, 594, 609, 594, 594, 595, 0, 0, 0, 0, 0, 0, 0, 0, 0], 
[0, 0, 0, 0, 0, 0, 0, 0, 0, 0, 0, 0, 0, 0, 0, 0, 0, 0, 0, 0], 
[0, 0, 623, 631, 0, 0, 0, 0, 0, 0, 0, 623, 631, 0, 0, 0, 0, 0, 0, 0], 
[623, 0, 621, 622, 0, 0, 0, 0, 0, 0, 0, 621, 622, 0, 623, 0, 0, 0, 0, 0], 
[631, 0, 629, 630, 0, 0, 0, 0, 0, 0, 0, 629, 630, 0, 631, 0, 0, 0, 0, 0], 
[481, 0, 0, 0, 0, 0, 552, 553, 554, 0, 0, 0, 0, 0, 482, 0, 0, 0, 0, 0], 
[0, 0, 0, 0, 0, 0, 560, 561, 562, 0, 0, 0, 0, 0, 0, 0, 0, 0, 0, 0], 
[0, 0, 0, 0, 0, 0, 0, 0, 0, 0, 0, 0, 0, 0, 0, 0, 0, 0, 0, 0], 
[0, 0, 0, 0, 0, 0, 0, 0, 0, 0, 0, 0, 0, 0, 0, 0, 0, 0, 0, 0], 
[0, 0, 0, 0, 0, 0, 0, 0, 0, 0, 0, 0, 0, 0, 0, 0, 0, 0, 0, 0], 
[0, 0, 0, 0, 0, 0, 0, 0, 0, 0, 0, 0, 0, 0, 0, 0, 0, 0, 0, 0], 
[0, 0, 0, 0, 0, 0, 0, 0, 0, 0, 0, 0, 0, 0, 0, 0, 0, 0, 0, 0]], 

[[0, 0, 0, 0, 0, 0, 0, 0, 0, 0, 0, 0, 0, 0, 0, 0, 0, 0, 0, 0], 
[0, 0, 0, 0, 0, 0, 0, 0, 0, 0, 0, 0, 0, 0, 0, 0, 0, 0, 0, 0], 
[0, 0, 0, 0, 606, 0, 0, 0, 0, 0, 606, 0, 0, 0, 0, 0, 0, 0, 0, 0], 
[0, 0, 0, 0, 614, 0, 0, 0, 0, 0, 614, 0, 0, 0, 0, 0, 0, 0, 0, 0], 
[0, 0, 0, 0, 0, 0, 0, 0, 0, 0, 0, 0, 0, 0, 0, 0, 0, 0, 0, 0], 
[0, 0, 0, 0, 0, 0, 0, 0, 0, 0, 0, 0, 0, 0, 0, 0, 0, 0, 0, 0], 
[0, 0, 0, 0, 0, 0, 0, 0, 0, 0, 0, 0, 0, 0, 0, 0, 0, 0, 0, 0], 
[0, 0, 0, 0, 0, 0, 0, 0, 0, 0, 0, 0, 0, 0, 0, 0, 0, 0, 0, 0], 
[0, 0, 0, 0, 0, 0, 0, 0, 0, 0, 0, 0, 0, 0, 0, 0, 0, 0, 0, 0], 
[0, 0, 0, 0, 0, 0, 0, 0, 0, 0, 0, 0, 0, 0, 0, 0, 0, 0, 0, 0], 
[0, 0, 0, 0, 0, 0, 0, 0, 0, 0, 0, 0, 0, 0, 0, 0, 0, 0, 0, 0], 
[0, 0, 0, 0, 0, 0, 0, 0, 0, 0, 0, 0, 0, 0, 0, 0, 0, 0, 0, 0], 
[0, 0, 0, 0, 0, 0, 0, 0, 0, 0, 0, 0, 0, 0, 0, 0, 0, 0, 0, 0], 
[0, 0, 0, 0, 0, 0, 0, 0, 0, 0, 0, 0, 0, 0, 0, 0, 0, 0, 0, 0], 
[0, 0, 0, 0, 0, 0, 0, 0, 0, 0, 0, 0, 0, 0, 0, 0, 0, 0, 0, 0]]]
}
}
