{
	"Map": {
		"id": 28,
		"map_display_x": 0,
		"map_display_y": 0,
		"width": 50,
		"height": 45,
		"xsize": 50,
		"ysize": 45,
		"zsize": 3,
		"Name" : "Natural Park",
		"Parent" : "",
		"Tileset" : "Outside",
		"BattleBack" : "",
		"Autoplay_bgm" : true,
		"BGM" : "018-Field01",
		"Autoplay_bgs" : false,
		"BGS" : "",
		"Encounter_list" : [],
		"Encounter_step" : 30,
		"table": [[[809, 808, 809, 808, 809, 808, 809, 808, 809, 808, 809, 808, 809, 808, 809, 808, 809, 808, 809, 808, 809, 808, 809, 808, 809, 808, 809, 808, 809, 808, 809, 808, 809, 808, 809, 808, 809, 808, 809, 808, 809, 808, 809, 808, 809, 808, 809, 808, 809, 808], 
[801, 800, 801, 800, 801, 800, 801, 800, 801, 800, 801, 800, 801, 800, 801, 800, 801, 800, 801, 800, 801, 800, 803, 818, 819, 818, 819, 818, 819, 818, 819, 802, 801, 800, 801, 800, 801, 800, 801, 800, 801, 800, 801, 800, 801, 800, 801, 800, 801, 800], 
[809, 808, 809, 808, 809, 808, 809, 808, 809, 808, 809, 808, 809, 808, 809, 808, 809, 808, 809, 808, 809, 808, 811, 385, 389, 386, 389, 388, 385, 389, 386, 810, 809, 808, 809, 808, 809, 808, 809, 808, 809, 808, 809, 808, 809, 808, 809, 808, 809, 808], 
[801, 800, 801, 800, 801, 800, 801, 800, 801, 800, 801, 800, 801, 800, 801, 800, 801, 800, 801, 800, 801, 800, 803, 387, 388, 385, 387, 386, 389, 387, 388, 802, 801, 800, 801, 800, 801, 800, 801, 800, 801, 800, 801, 800, 801, 800, 801, 800, 801, 800], 
[809, 808, 809, 808, 809, 808, 809, 808, 809, 808, 809, 808, 809, 808, 809, 808, 809, 808, 809, 808, 809, 808, 811, 389, 388, 388, 389, 389, 386, 388, 385, 810, 809, 808, 809, 808, 809, 808, 809, 808, 809, 808, 809, 808, 809, 808, 809, 808, 809, 808], 
[819, 818, 819, 802, 801, 800, 801, 800, 801, 800, 801, 800, 801, 800, 801, 800, 801, 800, 801, 800, 803, 818, 819, 386, 389, 387, 385, 386, 385, 389, 387, 818, 819, 802, 801, 800, 801, 800, 801, 800, 801, 800, 801, 800, 801, 800, 801, 800, 801, 800], 
[385, 385, 385, 810, 809, 808, 809, 808, 809, 808, 809, 808, 809, 808, 809, 808, 809, 808, 809, 808, 811, 389, 389, 385, 386, 388, 389, 385, 389, 387, 389, 385, 385, 810, 809, 808, 809, 808, 809, 808, 809, 808, 809, 808, 809, 808, 809, 808, 809, 808], 
[1089, 1090, 388, 802, 801, 800, 801, 800, 801, 800, 801, 800, 801, 800, 801, 800, 801, 800, 801, 800, 803, 386, 275, 273, 285, 385, 386, 388, 385, 283, 273, 277, 385, 802, 801, 800, 801, 800, 801, 800, 801, 800, 801, 800, 801, 800, 801, 800, 801, 800], 
[1097, 1098, 389, 810, 809, 808, 809, 808, 809, 808, 809, 808, 809, 808, 809, 808, 809, 808, 809, 808, 811, 389, 272, 387, 389, 385, 388, 388, 389, 388, 385, 272, 385, 810, 809, 808, 809, 808, 809, 808, 809, 808, 809, 808, 809, 808, 809, 808, 809, 808], 
[1092, 1098, 388, 802, 801, 800, 801, 800, 801, 800, 801, 800, 801, 800, 801, 800, 803, 818, 819, 818, 819, 385, 272, 388, 386, 389, 388, 387, 385, 385, 389, 272, 388, 818, 819, 818, 819, 802, 801, 800, 801, 800, 801, 800, 801, 800, 801, 800, 801, 800], 
[1096, 1098, 385, 810, 809, 808, 809, 808, 809, 808, 809, 808, 809, 808, 809, 808, 811, 389, 385, 388, 388, 387, 284, 386, 385, 387, 386, 387, 387, 388, 385, 284, 387, 387, 385, 385, 386, 810, 809, 808, 809, 808, 809, 808, 809, 808, 809, 808, 809, 808], 
[1233, 1233, 385, 802, 801, 800, 801, 800, 801, 800, 801, 800, 801, 800, 803, 818, 819, 385, 275, 273, 273, 285, 386, 387, 389, 386, 385, 388, 389, 386, 387, 388, 283, 273, 273, 277, 385, 818, 819, 802, 801, 800, 801, 800, 801, 800, 801, 800, 801, 800], 
[385, 810, 811, 810, 809, 808, 809, 808, 809, 808, 809, 808, 809, 808, 811, 389, 385, 389, 284, 385, 386, 389, 387, 385, 399, 399, 399, 399, 399, 399, 389, 385, 389, 385, 388, 284, 386, 389, 387, 810, 809, 808, 809, 808, 809, 808, 809, 808, 809, 808], 
[385, 818, 819, 802, 801, 800, 801, 800, 801, 800, 801, 800, 803, 818, 819, 385, 275, 285, 388, 387, 389, 388, 385, 386, 399, 399, 399, 399, 399, 399, 386, 389, 386, 387, 385, 387, 283, 277, 385, 818, 819, 802, 801, 800, 801, 800, 801, 800, 801, 800], 
[539, 388, 389, 810, 809, 808, 809, 808, 809, 808, 809, 808, 811, 389, 386, 388, 284, 387, 386, 385, 399, 399, 399, 399, 399, 399, 399, 399, 399, 399, 399, 399, 399, 399, 385, 387, 385, 284, 386, 388, 385, 810, 809, 808, 809, 808, 809, 808, 809, 808], 
[547, 388, 385, 802, 801, 800, 801, 800, 801, 800, 803, 818, 819, 385, 275, 285, 387, 385, 386, 387, 399, 399, 399, 399, 399, 399, 399, 399, 399, 399, 399, 399, 399, 399, 385, 388, 387, 386, 283, 277, 389, 818, 819, 802, 801, 800, 801, 800, 801, 800], 
[555, 387, 388, 810, 809, 808, 809, 808, 809, 808, 811, 389, 386, 387, 284, 389, 385, 387, 399, 399, 399, 399, 399, 399, 399, 399, 399, 399, 399, 399, 399, 399, 399, 399, 399, 399, 389, 388, 387, 284, 387, 386, 387, 810, 809, 808, 809, 808, 809, 808], 
[385, 386, 389, 802, 801, 800, 801, 800, 801, 800, 803, 385, 275, 285, 388, 386, 385, 388, 399, 399, 399, 399, 399, 399, 385, 388, 387, 385, 386, 389, 399, 399, 399, 399, 399, 399, 385, 385, 385, 385, 283, 277, 385, 802, 801, 800, 801, 800, 801, 800], 
[389, 286, 385, 810, 809, 808, 809, 808, 809, 808, 811, 388, 272, 387, 389, 385, 399, 399, 399, 399, 399, 399, 399, 399, 387, 386, 385, 387, 389, 385, 399, 399, 399, 399, 399, 399, 399, 399, 386, 387, 385, 272, 388, 810, 809, 808, 809, 808, 809, 808], 
[285, 388, 385, 802, 801, 800, 803, 818, 819, 818, 819, 385, 272, 385, 386, 387, 399, 399, 399, 399, 399, 399, 387, 388, 386, 388, 1088, 1090, 386, 388, 387, 389, 399, 399, 399, 399, 399, 399, 389, 385, 388, 272, 386, 802, 801, 800, 801, 800, 801, 800], 
[387, 286, 389, 810, 809, 808, 811, 386, 386, 385, 388, 385, 284, 389, 399, 399, 399, 399, 399, 399, 399, 399, 389, 385, 387, 389, 1096, 1098, 387, 389, 385, 386, 399, 399, 399, 399, 399, 399, 399, 399, 386, 272, 385, 810, 809, 808, 809, 808, 809, 808], 
[285, 388, 385, 818, 819, 818, 819, 388, 283, 273, 273, 285, 387, 387, 399, 399, 399, 399, 399, 399, 387, 386, 388, 387, 1088, 1089, 1104, 1106, 1089, 1090, 385, 387, 388, 386, 399, 399, 399, 399, 399, 399, 389, 272, 387, 802, 801, 800, 801, 800, 801, 800], 
[388, 385, 385, 387, 386, 385, 387, 385, 386, 387, 386, 387, 386, 385, 399, 399, 399, 399, 399, 399, 389, 385, 385, 388, 1096, 1097, 1097, 1097, 1097, 1098, 388, 385, 389, 385, 399, 399, 399, 399, 399, 399, 385, 272, 386, 810, 809, 808, 809, 808, 809, 808], 
[538, 538, 539, 387, 386, 385, 386, 387, 387, 385, 387, 388, 389, 389, 386, 388, 389, 387, 386, 388, 386, 387, 1088, 1089, 1104, 1091, 1232, 1234, 1092, 1106, 1089, 1090, 387, 385, 385, 386, 385, 387, 388, 386, 387, 272, 386, 802, 801, 800, 801, 800, 801, 800], 
[546, 546, 547, 385, 387, 386, 388, 387, 389, 389, 385, 386, 385, 386, 387, 386, 388, 389, 385, 386, 387, 385, 1096, 1097, 1097, 1098, 385, 385, 1096, 1097, 1097, 1098, 389, 388, 385, 385, 389, 386, 385, 388, 388, 272, 388, 810, 809, 808, 809, 808, 809, 808], 
[554, 554, 555, 385, 385, 385, 385, 385, 387, 386, 388, 387, 389, 386, 390, 390, 390, 390, 390, 390, 387, 388, 1233, 1234, 1092, 1106, 1089, 1089, 1104, 1091, 1232, 1233, 387, 388, 390, 390, 390, 390, 390, 390, 385, 272, 385, 802, 801, 800, 801, 800, 801, 800], 
[387, 389, 387, 810, 811, 810, 811, 386, 283, 273, 273, 285, 385, 386, 390, 390, 390, 390, 390, 390, 389, 386, 389, 388, 1096, 1097, 1097, 1097, 1097, 1098, 385, 387, 386, 386, 390, 390, 390, 390, 390, 390, 387, 272, 388, 810, 809, 808, 809, 808, 809, 808], 
[386, 388, 385, 802, 801, 800, 803, 388, 385, 387, 389, 388, 282, 389, 390, 390, 390, 390, 390, 390, 390, 390, 387, 386, 1233, 1234, 1092, 1091, 1232, 1233, 388, 386, 390, 390, 390, 390, 390, 390, 390, 390, 389, 272, 387, 802, 801, 800, 801, 800, 801, 800], 
[386, 286, 386, 810, 809, 808, 811, 810, 811, 810, 811, 387, 272, 387, 390, 390, 390, 390, 390, 390, 390, 390, 388, 385, 388, 387, 1096, 1098, 389, 386, 388, 387, 390, 390, 390, 390, 390, 390, 390, 390, 385, 272, 387, 810, 809, 808, 809, 808, 809, 808], 
[387, 386, 385, 802, 801, 800, 801, 800, 801, 800, 803, 385, 272, 386, 386, 388, 390, 390, 390, 390, 390, 390, 390, 390, 386, 388, 1233, 1233, 387, 388, 390, 390, 390, 390, 390, 390, 390, 390, 385, 386, 388, 272, 389, 802, 801, 800, 801, 800, 801, 800], 
[385, 286, 388, 810, 809, 808, 809, 808, 809, 808, 811, 388, 281, 285, 385, 387, 390, 390, 390, 390, 390, 390, 390, 390, 389, 388, 387, 385, 386, 387, 390, 390, 390, 390, 390, 390, 390, 390, 388, 387, 283, 279, 385, 810, 809, 808, 809, 808, 809, 808], 
[539, 386, 389, 802, 801, 800, 801, 800, 801, 800, 803, 385, 385, 388, 282, 389, 385, 387, 390, 390, 390, 390, 390, 390, 390, 390, 390, 390, 390, 390, 390, 390, 390, 390, 390, 390, 386, 389, 385, 282, 386, 388, 387, 802, 801, 800, 801, 800, 801, 800], 
[547, 387, 388, 810, 809, 808, 809, 808, 809, 808, 811, 810, 811, 386, 281, 285, 387, 386, 390, 390, 390, 390, 390, 390, 390, 390, 390, 390, 390, 390, 390, 390, 390, 390, 390, 390, 388, 387, 283, 279, 389, 810, 811, 810, 809, 808, 809, 808, 809, 808], 
[555, 387, 385, 802, 801, 800, 801, 800, 801, 800, 801, 800, 803, 387, 385, 387, 282, 388, 385, 386, 390, 390, 390, 390, 390, 390, 390, 390, 390, 390, 390, 390, 390, 390, 385, 385, 387, 282, 385, 387, 385, 802, 801, 800, 801, 800, 801, 800, 801, 800], 
[386, 386, 389, 810, 809, 808, 809, 808, 809, 808, 809, 808, 811, 810, 811, 389, 281, 285, 389, 387, 390, 390, 390, 390, 390, 390, 390, 390, 390, 390, 390, 390, 390, 390, 385, 389, 283, 279, 388, 810, 811, 810, 809, 808, 809, 808, 809, 808, 809, 808], 
[273, 277, 385, 802, 801, 800, 801, 800, 801, 800, 801, 800, 801, 800, 803, 388, 385, 389, 282, 385, 386, 389, 385, 388, 390, 390, 390, 390, 390, 390, 385, 387, 388, 388, 386, 282, 385, 387, 386, 802, 801, 800, 801, 800, 801, 800, 801, 800, 801, 800], 
[386, 284, 387, 810, 809, 808, 809, 808, 809, 808, 809, 808, 809, 808, 811, 810, 811, 386, 281, 273, 273, 285, 387, 386, 390, 390, 390, 390, 390, 390, 386, 387, 283, 273, 273, 279, 387, 810, 811, 810, 809, 808, 809, 808, 809, 808, 809, 808, 809, 808], 
[385, 386, 386, 802, 801, 800, 801, 800, 801, 800, 801, 800, 801, 800, 801, 800, 803, 387, 385, 386, 387, 385, 282, 388, 385, 387, 385, 387, 386, 385, 388, 282, 385, 386, 385, 387, 388, 802, 801, 800, 801, 800, 801, 800, 801, 800, 801, 800, 801, 800], 
[811, 810, 811, 810, 809, 808, 809, 808, 809, 808, 809, 808, 809, 808, 809, 808, 811, 810, 811, 810, 811, 389, 281, 273, 273, 273, 273, 273, 273, 273, 273, 279, 389, 810, 811, 810, 811, 810, 809, 808, 809, 808, 809, 808, 809, 808, 809, 808, 809, 808], 
[801, 800, 801, 800, 801, 800, 801, 800, 801, 800, 801, 800, 801, 800, 801, 800, 801, 800, 801, 800, 803, 386, 385, 387, 389, 386, 385, 385, 385, 387, 386, 385, 386, 802, 801, 800, 801, 800, 801, 800, 801, 800, 801, 800, 801, 800, 801, 800, 801, 800], 
[809, 808, 809, 808, 809, 808, 809, 808, 809, 808, 809, 808, 809, 808, 809, 808, 809, 808, 809, 808, 811, 810, 811, 810, 811, 810, 811, 810, 811, 810, 811, 810, 811, 810, 809, 808, 809, 808, 809, 808, 809, 808, 809, 808, 809, 808, 809, 808, 809, 808], 
[801, 800, 801, 800, 801, 800, 801, 800, 801, 800, 801, 800, 801, 800, 801, 800, 801, 800, 801, 800, 801, 800, 801, 800, 801, 800, 801, 800, 801, 800, 801, 800, 801, 800, 801, 800, 801, 800, 801, 800, 801, 800, 801, 800, 801, 800, 801, 800, 801, 800], 
[809, 808, 809, 808, 809, 808, 809, 808, 809, 808, 809, 808, 809, 808, 809, 808, 809, 808, 809, 808, 809, 808, 809, 808, 809, 808, 809, 808, 809, 808, 809, 808, 809, 808, 809, 808, 809, 808, 809, 808, 809, 808, 809, 808, 809, 808, 809, 808, 809, 808], 
[801, 800, 801, 800, 801, 800, 801, 800, 801, 800, 801, 800, 801, 800, 801, 800, 801, 800, 801, 800, 801, 800, 801, 800, 801, 800, 801, 800, 801, 800, 801, 800, 801, 800, 801, 800, 801, 800, 801, 800, 801, 800, 801, 800, 801, 800, 801, 800, 801, 800], 
[809, 808, 809, 808, 809, 808, 809, 808, 809, 808, 809, 808, 809, 808, 809, 808, 809, 808, 809, 808, 809, 808, 809, 808, 809, 808, 809, 808, 809, 808, 809, 808, 809, 808, 809, 808, 809, 808, 809, 808, 809, 808, 809, 808, 809, 808, 809, 808, 809, 808]], 

[[0, 0, 0, 0, 0, 0, 0, 0, 0, 0, 0, 0, 0, 0, 0, 0, 0, 0, 0, 0, 0, 0, 0, 0, 0, 0, 0, 0, 0, 0, 0, 0, 0, 0, 0, 0, 0, 0, 0, 0, 0, 0, 0, 0, 0, 0, 0, 0, 0, 0], 
[0, 0, 0, 0, 0, 0, 0, 0, 0, 0, 0, 0, 0, 0, 0, 0, 0, 0, 0, 0, 0, 0, 0, 3352, 3353, 3353, 3353, 3353, 3353, 3353, 3354, 0, 0, 0, 0, 0, 0, 0, 0, 0, 0, 0, 0, 0, 0, 0, 0, 0, 0, 0], 
[0, 0, 0, 0, 0, 0, 0, 0, 0, 0, 0, 0, 0, 0, 0, 0, 0, 0, 0, 0, 0, 0, 0, 3360, 3361, 3361, 3361, 3361, 3361, 3361, 3362, 0, 0, 0, 0, 0, 0, 0, 0, 0, 0, 0, 0, 0, 0, 0, 0, 0, 0, 0], 
[0, 0, 0, 0, 0, 0, 0, 0, 0, 0, 0, 0, 0, 0, 0, 0, 0, 0, 0, 0, 0, 0, 0, 3305, 3306, 3306, 3306, 3306, 3306, 3306, 3309, 0, 0, 0, 0, 0, 0, 0, 0, 0, 0, 0, 0, 0, 0, 0, 0, 0, 0, 0], 
[0, 0, 0, 0, 0, 0, 0, 0, 0, 0, 0, 0, 0, 0, 0, 0, 0, 0, 0, 0, 0, 0, 0, 3313, 3336, 3337, 3338, 3336, 3337, 3338, 3317, 0, 0, 0, 0, 0, 0, 0, 0, 0, 0, 0, 0, 0, 0, 0, 0, 0, 0, 0], 
[0, 0, 0, 0, 0, 0, 0, 0, 0, 0, 0, 0, 0, 0, 0, 0, 0, 0, 0, 0, 0, 0, 0, 3376, 3377, 3348, 3349, 3349, 3350, 3377, 3378, 0, 0, 0, 0, 0, 0, 0, 0, 0, 0, 0, 0, 0, 0, 0, 0, 0, 0, 0], 
[1681, 1681, 1663, 0, 0, 0, 0, 0, 0, 0, 0, 0, 0, 0, 0, 0, 0, 0, 0, 0, 0, 1658, 1682, 3321, 3385, 3322, 3323, 3323, 3324, 3385, 3325, 1680, 1661, 0, 0, 0, 0, 0, 0, 0, 0, 0, 0, 0, 0, 0, 0, 0, 0, 0], 
[0, 0, 1664, 0, 0, 0, 0, 0, 0, 0, 0, 0, 0, 0, 0, 0, 0, 0, 0, 0, 0, 1664, 0, 0, 0, 3330, 3331, 3331, 3332, 0, 0, 0, 1665, 0, 0, 0, 0, 0, 0, 0, 0, 0, 0, 0, 0, 0, 0, 0, 0, 0], 
[0, 0, 1664, 0, 0, 0, 0, 0, 0, 0, 0, 0, 0, 0, 0, 0, 0, 0, 0, 0, 0, 1664, 0, 0, 0, 0, 0, 0, 0, 0, 0, 0, 1665, 0, 0, 0, 0, 0, 0, 0, 0, 0, 0, 0, 0, 0, 0, 0, 0, 0], 
[0, 0, 1664, 0, 0, 0, 0, 0, 0, 0, 0, 0, 0, 0, 0, 0, 0, 0, 0, 0, 0, 1664, 0, 0, 0, 0, 0, 0, 0, 0, 0, 0, 1665, 0, 0, 0, 0, 0, 0, 0, 0, 0, 0, 0, 0, 0, 0, 0, 0, 0], 
[1885, 0, 1664, 0, 0, 0, 0, 0, 0, 0, 0, 0, 0, 0, 0, 0, 0, 1658, 1681, 1681, 1681, 1679, 0, 0, 0, 0, 0, 0, 0, 0, 0, 0, 1678, 1681, 1681, 1681, 1661, 0, 0, 0, 0, 0, 0, 0, 0, 0, 0, 0, 0, 0], 
[1893, 1681, 1679, 0, 0, 0, 0, 0, 0, 0, 0, 0, 0, 0, 0, 0, 0, 1664, 0, 0, 0, 0, 0, 0, 391, 391, 391, 391, 391, 391, 0, 0, 0, 0, 0, 0, 1665, 0, 0, 0, 0, 0, 0, 0, 0, 0, 0, 0, 0, 0], 
[1901, 0, 0, 0, 0, 0, 0, 0, 0, 0, 0, 0, 0, 0, 0, 1658, 1681, 1679, 0, 0, 0, 0, 0, 0, 391, 391, 391, 391, 391, 391, 0, 0, 0, 0, 0, 0, 1678, 1681, 1661, 0, 0, 0, 0, 0, 0, 0, 0, 0, 0, 0], 
[1909, 0, 0, 0, 0, 0, 0, 0, 0, 0, 0, 0, 0, 0, 0, 1664, 0, 0, 0, 0, 391, 391, 391, 391, 391, 391, 391, 391, 391, 391, 391, 391, 391, 391, 0, 0, 0, 0, 1665, 0, 0, 0, 0, 0, 0, 0, 0, 0, 0, 0], 
[0, 0, 1657, 0, 0, 0, 0, 0, 0, 0, 0, 0, 0, 1658, 1681, 1679, 0, 0, 0, 0, 391, 391, 391, 391, 391, 391, 391, 391, 391, 391, 391, 391, 391, 391, 0, 0, 0, 0, 1678, 1681, 1661, 0, 0, 0, 0, 0, 0, 0, 0, 0], 
[0, 0, 1665, 0, 0, 0, 0, 0, 0, 0, 0, 0, 0, 1664, 0, 0, 0, 0, 391, 391, 391, 391, 391, 391, 391, 391, 391, 391, 391, 391, 391, 391, 391, 391, 391, 391, 0, 0, 0, 0, 1665, 0, 0, 0, 0, 0, 0, 0, 0, 0], 
[0, 0, 1665, 0, 0, 0, 0, 0, 0, 0, 0, 1658, 1681, 1679, 0, 0, 0, 0, 391, 391, 391, 391, 391, 391, 0, 0, 0, 0, 0, 0, 391, 391, 391, 391, 391, 391, 0, 0, 0, 0, 1678, 1681, 1661, 0, 0, 0, 0, 0, 0, 0], 
[0, 0, 1665, 0, 0, 0, 0, 0, 0, 0, 0, 1664, 0, 0, 0, 0, 391, 391, 391, 391, 391, 391, 391, 391, 0, 0, 0, 0, 0, 0, 391, 391, 391, 391, 391, 391, 391, 391, 0, 0, 0, 0, 1665, 0, 0, 0, 0, 0, 0, 0], 
[0, 0, 1665, 0, 0, 0, 0, 0, 0, 0, 0, 1664, 0, 0, 0, 0, 391, 391, 391, 391, 391, 391, 0, 0, 0, 1662, 1681, 1681, 1663, 0, 0, 0, 391, 391, 391, 391, 391, 391, 0, 0, 0, 0, 1665, 0, 0, 0, 0, 0, 0, 0], 
[0, 0, 1665, 0, 0, 0, 0, 0, 0, 0, 0, 1664, 0, 0, 391, 391, 391, 391, 391, 391, 391, 391, 0, 0, 0, 1665, 1128, 1130, 1664, 0, 0, 0, 391, 391, 391, 391, 391, 391, 391, 391, 0, 0, 1665, 0, 0, 0, 0, 0, 0, 0], 
[0, 0, 1665, 0, 0, 0, 0, 1658, 1681, 1681, 1681, 1679, 0, 0, 391, 391, 391, 391, 391, 391, 0, 0, 0, 1662, 1681, 1677, 1136, 1138, 1674, 1681, 1663, 0, 0, 0, 391, 391, 391, 391, 391, 391, 0, 0, 1665, 0, 0, 0, 0, 0, 0, 0], 
[0, 0, 1673, 3353, 3353, 3353, 3353, 1672, 0, 0, 0, 0, 0, 0, 391, 391, 391, 391, 391, 391, 0, 0, 0, 1665, 1128, 1129, 1144, 1146, 1129, 1130, 1664, 0, 0, 0, 391, 391, 391, 391, 391, 391, 0, 0, 1665, 0, 0, 0, 0, 0, 0, 0], 
[0, 3296, 3360, 3361, 3361, 3361, 3361, 3362, 3302, 0, 0, 0, 0, 0, 0, 0, 0, 0, 0, 0, 0, 1662, 1681, 1677, 1136, 0, 0, 0, 0, 1138, 1674, 1681, 1663, 0, 0, 0, 0, 0, 0, 0, 0, 0, 1665, 0, 0, 0, 0, 0, 0, 0], 
[0, 3304, 3305, 3306, 3306, 3306, 3306, 3309, 3310, 0, 0, 0, 0, 0, 0, 0, 0, 0, 0, 0, 0, 1665, 1128, 1129, 1144, 1131, 0, 0, 1132, 1146, 1129, 1130, 1664, 0, 0, 0, 0, 0, 0, 0, 0, 0, 1665, 0, 0, 0, 0, 0, 0, 0], 
[0, 3312, 3344, 3345, 3345, 3345, 3345, 3346, 3318, 0, 0, 0, 0, 0, 0, 0, 0, 0, 0, 0, 0, 1665, 1136, 0, 0, 1138, 0, 0, 1136, 0, 0, 1138, 1664, 0, 0, 0, 0, 0, 0, 0, 0, 0, 1665, 0, 0, 0, 0, 0, 0, 0], 
[0, 3320, 3384, 3385, 3385, 3385, 3385, 3386, 3326, 0, 0, 0, 0, 0, 0, 0, 0, 0, 0, 0, 0, 1678, 1681, 1661, 1132, 1146, 1129, 1129, 1144, 1131, 1658, 1681, 1679, 0, 0, 0, 0, 0, 0, 0, 0, 0, 1665, 0, 0, 0, 0, 0, 0, 0], 
[0, 0, 1657, 0, 0, 0, 0, 1656, 0, 0, 0, 0, 0, 0, 0, 0, 0, 0, 0, 0, 0, 0, 0, 1665, 1136, 0, 0, 0, 0, 1138, 1664, 0, 0, 0, 0, 0, 0, 0, 0, 0, 0, 0, 1665, 0, 0, 0, 0, 0, 0, 0], 
[1885, 0, 1665, 0, 0, 0, 0, 1674, 1681, 1681, 1681, 1663, 0, 0, 0, 0, 0, 0, 0, 0, 0, 0, 0, 1678, 1681, 1661, 1132, 1131, 1658, 1681, 1679, 0, 0, 0, 0, 0, 0, 0, 0, 0, 0, 0, 1665, 0, 0, 0, 0, 0, 0, 0], 
[1893, 0, 1665, 0, 0, 0, 0, 0, 0, 0, 0, 1664, 0, 0, 0, 0, 0, 0, 0, 0, 0, 0, 0, 0, 0, 1665, 1136, 1138, 1664, 0, 0, 0, 0, 0, 0, 0, 0, 0, 0, 0, 0, 0, 1665, 0, 0, 0, 0, 0, 0, 0], 
[1901, 0, 1665, 0, 0, 0, 0, 0, 0, 0, 0, 1664, 0, 0, 0, 0, 0, 0, 0, 0, 0, 0, 0, 0, 0, 1678, 1678, 1678, 1679, 0, 0, 0, 0, 0, 0, 0, 0, 0, 0, 0, 0, 0, 1665, 0, 0, 0, 0, 0, 0, 0], 
[1909, 0, 1665, 0, 0, 0, 0, 0, 0, 0, 0, 1664, 0, 0, 0, 0, 0, 0, 0, 0, 0, 0, 0, 0, 0, 0, 0, 0, 0, 0, 0, 0, 0, 0, 0, 0, 0, 0, 0, 0, 0, 0, 1665, 0, 0, 0, 0, 0, 0, 0], 
[0, 0, 1665, 0, 0, 0, 0, 0, 0, 0, 0, 1674, 1681, 1663, 0, 0, 0, 0, 0, 0, 0, 0, 0, 0, 0, 0, 0, 0, 0, 0, 0, 0, 0, 0, 0, 0, 0, 0, 0, 0, 1662, 1681, 1677, 0, 0, 0, 0, 0, 0, 0], 
[0, 0, 1665, 0, 0, 0, 0, 0, 0, 0, 0, 0, 0, 1664, 0, 0, 0, 0, 0, 0, 0, 0, 0, 0, 0, 0, 0, 0, 0, 0, 0, 0, 0, 0, 0, 0, 0, 0, 0, 0, 1665, 0, 0, 0, 0, 0, 0, 0, 0, 0], 
[0, 0, 1665, 0, 0, 0, 0, 0, 0, 0, 0, 0, 0, 1674, 1681, 1663, 0, 0, 0, 0, 0, 0, 0, 0, 0, 0, 0, 0, 0, 0, 0, 0, 0, 0, 0, 0, 0, 0, 1662, 1681, 1677, 0, 0, 0, 0, 0, 0, 0, 0, 0], 
[1070, 1071, 1665, 0, 0, 0, 0, 0, 0, 0, 0, 0, 0, 0, 0, 1664, 0, 0, 0, 0, 0, 0, 0, 0, 0, 0, 0, 0, 0, 0, 0, 0, 0, 0, 0, 0, 0, 0, 1665, 0, 0, 0, 0, 0, 0, 0, 0, 0, 0, 0], 
[0, 0, 1665, 0, 0, 0, 0, 0, 0, 0, 0, 0, 0, 0, 0, 1674, 1681, 1663, 0, 0, 0, 0, 0, 0, 0, 0, 0, 0, 0, 0, 0, 0, 0, 0, 0, 0, 1662, 1681, 1677, 0, 0, 0, 0, 0, 0, 0, 0, 0, 0, 0], 
[0, 0, 1665, 0, 0, 0, 0, 0, 0, 0, 0, 0, 0, 0, 0, 0, 0, 1664, 0, 0, 0, 0, 0, 0, 0, 0, 0, 0, 0, 0, 0, 0, 0, 0, 0, 0, 1665, 0, 0, 0, 0, 0, 0, 0, 0, 0, 0, 0, 0, 0], 
[1681, 1681, 1677, 0, 0, 0, 0, 0, 0, 0, 0, 0, 0, 0, 0, 0, 0, 1674, 1681, 1681, 1681, 1663, 0, 0, 0, 0, 0, 0, 0, 0, 0, 0, 1662, 1681, 1681, 1681, 1677, 0, 0, 0, 0, 0, 0, 0, 0, 0, 0, 0, 0, 0], 
[0, 0, 0, 0, 0, 0, 0, 0, 0, 0, 0, 0, 0, 0, 0, 0, 0, 0, 0, 0, 0, 1664, 0, 0, 0, 0, 0, 0, 0, 0, 0, 0, 1665, 0, 0, 0, 0, 0, 0, 0, 0, 0, 0, 0, 0, 0, 0, 0, 0, 0], 
[0, 0, 0, 0, 0, 0, 0, 0, 0, 0, 0, 0, 0, 0, 0, 0, 0, 0, 0, 0, 0, 1674, 1681, 1681, 1681, 1681, 1681, 1681, 1681, 1681, 1681, 1681, 1677, 0, 0, 0, 0, 0, 0, 0, 0, 0, 0, 0, 0, 0, 0, 0, 0, 0], 
[0, 0, 0, 0, 0, 0, 0, 0, 0, 0, 0, 0, 0, 0, 0, 0, 0, 0, 0, 0, 0, 0, 0, 0, 0, 0, 0, 0, 0, 0, 0, 0, 0, 0, 0, 0, 0, 0, 0, 0, 0, 0, 0, 0, 0, 0, 0, 0, 0, 0], 
[0, 0, 0, 0, 0, 0, 0, 0, 0, 0, 0, 0, 0, 0, 0, 0, 0, 0, 0, 0, 0, 0, 0, 0, 0, 0, 0, 0, 0, 0, 0, 0, 0, 0, 0, 0, 0, 0, 0, 0, 0, 0, 0, 0, 0, 0, 0, 0, 0, 0], 
[0, 0, 0, 0, 0, 0, 0, 0, 0, 0, 0, 0, 0, 0, 0, 0, 0, 0, 0, 0, 0, 0, 0, 0, 0, 0, 0, 0, 0, 0, 0, 0, 0, 0, 0, 0, 0, 0, 0, 0, 0, 0, 0, 0, 0, 0, 0, 0, 0, 0], 
[0, 0, 0, 0, 0, 0, 0, 0, 0, 0, 0, 0, 0, 0, 0, 0, 0, 0, 0, 0, 0, 0, 0, 0, 0, 0, 0, 0, 0, 0, 0, 0, 0, 0, 0, 0, 0, 0, 0, 0, 0, 0, 0, 0, 0, 0, 0, 0, 0, 0], 
[0, 0, 0, 0, 0, 0, 0, 0, 0, 0, 0, 0, 0, 0, 0, 0, 0, 0, 0, 0, 0, 0, 0, 0, 0, 0, 0, 0, 0, 0, 0, 0, 0, 0, 0, 0, 0, 0, 0, 0, 0, 0, 0, 0, 0, 0, 0, 0, 0, 0]], 

[[0, 0, 0, 0, 0, 0, 0, 0, 0, 0, 0, 0, 0, 0, 0, 0, 0, 0, 0, 0, 0, 0, 0, 0, 0, 0, 0, 0, 0, 0, 0, 0, 0, 0, 0, 0, 0, 0, 0, 0, 0, 0, 0, 0, 0, 0, 0, 0, 0, 0], 
[0, 0, 0, 0, 0, 0, 0, 0, 0, 0, 0, 0, 0, 0, 0, 0, 0, 0, 0, 0, 0, 0, 0, 0, 0, 0, 0, 0, 0, 0, 0, 0, 0, 0, 0, 0, 0, 0, 0, 0, 0, 0, 0, 0, 0, 0, 0, 0, 0, 0], 
[0, 0, 0, 0, 0, 0, 0, 0, 0, 0, 0, 0, 0, 0, 0, 0, 0, 0, 0, 0, 0, 0, 0, 0, 0, 0, 0, 0, 0, 0, 0, 0, 0, 0, 0, 0, 0, 0, 0, 0, 0, 0, 0, 0, 0, 0, 0, 0, 0, 0], 
[0, 0, 0, 0, 0, 0, 0, 0, 0, 0, 0, 0, 0, 0, 0, 0, 0, 0, 0, 0, 0, 0, 0, 0, 0, 0, 0, 0, 0, 0, 0, 0, 0, 0, 0, 0, 0, 0, 0, 0, 0, 0, 0, 0, 0, 0, 0, 0, 0, 0], 
[0, 0, 0, 0, 0, 0, 0, 0, 0, 0, 0, 0, 0, 0, 0, 0, 0, 0, 0, 0, 0, 0, 0, 0, 0, 0, 0, 0, 0, 0, 0, 0, 0, 0, 0, 0, 0, 0, 0, 0, 0, 0, 0, 0, 0, 0, 0, 0, 0, 0], 
[0, 0, 0, 0, 0, 0, 0, 0, 0, 0, 0, 0, 0, 0, 0, 0, 0, 0, 0, 0, 0, 0, 0, 0, 0, 0, 0, 0, 0, 0, 0, 0, 0, 0, 0, 0, 0, 0, 0, 0, 0, 0, 0, 0, 0, 0, 0, 0, 0, 0], 
[0, 0, 0, 0, 0, 0, 0, 0, 0, 0, 0, 0, 0, 0, 0, 0, 0, 0, 0, 0, 0, 0, 0, 0, 0, 0, 0, 0, 0, 0, 0, 0, 0, 0, 0, 0, 0, 0, 0, 0, 0, 0, 0, 0, 0, 0, 0, 0, 0, 0], 
[0, 0, 0, 0, 0, 0, 0, 0, 0, 0, 0, 0, 0, 0, 0, 0, 0, 0, 0, 0, 0, 0, 0, 0, 0, 0, 0, 0, 0, 0, 0, 0, 0, 0, 0, 0, 0, 0, 0, 0, 0, 0, 0, 0, 0, 0, 0, 0, 0, 0], 
[0, 0, 0, 0, 0, 0, 0, 0, 0, 0, 0, 0, 0, 0, 0, 0, 0, 0, 0, 0, 0, 0, 0, 0, 0, 0, 0, 0, 0, 0, 0, 0, 0, 0, 0, 0, 0, 0, 0, 0, 0, 0, 0, 0, 0, 0, 0, 0, 0, 0], 
[0, 0, 0, 0, 0, 0, 0, 0, 0, 0, 0, 0, 0, 0, 0, 0, 0, 0, 0, 0, 0, 0, 0, 0, 0, 0, 0, 0, 0, 0, 0, 0, 0, 0, 0, 0, 0, 0, 0, 0, 0, 0, 0, 0, 0, 0, 0, 0, 0, 0], 
[0, 0, 0, 0, 0, 0, 0, 0, 0, 0, 0, 0, 0, 0, 0, 0, 0, 0, 0, 0, 0, 0, 0, 0, 0, 0, 0, 0, 0, 0, 0, 0, 0, 0, 0, 0, 0, 0, 0, 0, 0, 0, 0, 0, 0, 0, 0, 0, 0, 0], 
[0, 804, 805, 0, 0, 0, 0, 0, 0, 0, 0, 0, 0, 0, 0, 0, 0, 0, 0, 0, 0, 0, 0, 0, 0, 0, 0, 0, 0, 0, 0, 0, 0, 0, 0, 0, 0, 0, 0, 0, 0, 0, 0, 0, 0, 0, 0, 0, 0, 0], 
[0, 0, 0, 0, 0, 0, 0, 0, 0, 0, 0, 0, 0, 0, 0, 0, 0, 0, 0, 0, 0, 0, 0, 0, 0, 0, 0, 0, 0, 0, 0, 0, 0, 0, 0, 0, 0, 0, 0, 0, 0, 0, 0, 0, 0, 0, 0, 0, 0, 0], 
[0, 0, 0, 0, 0, 0, 0, 0, 0, 0, 0, 0, 0, 0, 0, 0, 0, 0, 0, 0, 0, 0, 0, 0, 0, 0, 0, 0, 0, 0, 0, 0, 0, 0, 0, 0, 0, 0, 0, 0, 0, 0, 0, 0, 0, 0, 0, 0, 0, 0], 
[0, 0, 0, 0, 0, 0, 0, 0, 0, 0, 0, 0, 0, 0, 0, 0, 0, 0, 0, 0, 0, 0, 0, 0, 0, 0, 0, 0, 0, 0, 0, 0, 0, 0, 0, 0, 0, 0, 0, 0, 0, 0, 0, 0, 0, 0, 0, 0, 0, 0], 
[0, 0, 0, 0, 0, 0, 0, 0, 0, 0, 0, 0, 0, 0, 0, 0, 0, 0, 0, 0, 0, 0, 0, 0, 0, 0, 0, 0, 0, 0, 0, 0, 0, 0, 0, 0, 0, 0, 0, 0, 0, 0, 0, 0, 0, 0, 0, 0, 0, 0], 
[0, 0, 0, 0, 0, 0, 0, 0, 0, 0, 0, 0, 0, 0, 0, 0, 0, 0, 0, 0, 0, 0, 0, 0, 0, 0, 0, 0, 0, 0, 0, 0, 0, 0, 0, 0, 0, 0, 0, 0, 0, 0, 0, 0, 0, 0, 0, 0, 0, 0], 
[0, 0, 0, 0, 0, 0, 0, 0, 0, 0, 0, 0, 0, 0, 0, 0, 0, 0, 0, 0, 0, 0, 0, 0, 0, 0, 0, 0, 0, 0, 0, 0, 0, 0, 0, 0, 0, 0, 0, 0, 0, 0, 0, 0, 0, 0, 0, 0, 0, 0], 
[0, 0, 0, 0, 0, 0, 0, 0, 0, 0, 0, 0, 0, 0, 0, 0, 0, 0, 0, 0, 0, 0, 0, 0, 0, 0, 0, 0, 0, 0, 0, 0, 0, 0, 0, 0, 0, 0, 0, 0, 0, 0, 0, 0, 0, 0, 0, 0, 0, 0], 
[0, 0, 0, 0, 0, 0, 0, 0, 0, 0, 0, 0, 0, 0, 0, 0, 0, 0, 0, 0, 0, 0, 0, 0, 0, 0, 0, 0, 0, 0, 0, 0, 0, 0, 0, 0, 0, 0, 0, 0, 0, 0, 0, 0, 0, 0, 0, 0, 0, 0], 
[0, 0, 0, 0, 0, 0, 0, 0, 0, 0, 0, 0, 0, 0, 0, 0, 0, 0, 0, 0, 0, 0, 0, 0, 0, 0, 0, 0, 0, 0, 0, 0, 0, 0, 0, 0, 0, 0, 0, 0, 0, 0, 0, 0, 0, 0, 0, 0, 0, 0], 
[0, 0, 3352, 0, 0, 0, 0, 3354, 0, 0, 0, 0, 0, 0, 0, 0, 0, 0, 0, 0, 0, 0, 0, 0, 0, 0, 1398, 1399, 0, 0, 0, 0, 0, 0, 0, 0, 0, 0, 0, 0, 0, 0, 0, 0, 0, 0, 0, 0, 0, 0], 
[0, 0, 0, 0, 0, 0, 0, 0, 0, 0, 0, 0, 0, 0, 0, 0, 0, 0, 0, 0, 0, 0, 0, 0, 0, 0, 1406, 1407, 0, 0, 0, 0, 0, 0, 0, 0, 0, 0, 0, 0, 0, 0, 0, 0, 0, 0, 0, 0, 0, 0], 
[0, 0, 0, 0, 0, 0, 0, 0, 0, 0, 0, 0, 0, 0, 0, 0, 0, 0, 0, 0, 0, 0, 0, 0, 0, 0, 1414, 1415, 0, 0, 0, 0, 0, 0, 0, 0, 0, 0, 0, 0, 0, 0, 0, 0, 0, 0, 0, 0, 0, 0], 
[0, 0, 0, 0, 0, 0, 0, 0, 0, 0, 0, 0, 0, 0, 0, 0, 0, 0, 0, 0, 0, 0, 0, 0, 0, 0, 1422, 1423, 0, 0, 0, 0, 0, 0, 0, 0, 0, 0, 0, 0, 0, 0, 0, 0, 0, 0, 0, 0, 0, 0], 
[0, 0, 0, 804, 805, 804, 805, 0, 0, 0, 0, 0, 0, 0, 0, 0, 0, 0, 0, 0, 0, 0, 0, 0, 0, 0, 0, 0, 0, 0, 0, 0, 0, 0, 0, 0, 0, 0, 0, 0, 0, 0, 0, 0, 0, 0, 0, 0, 0, 0], 
[0, 0, 0, 0, 0, 0, 0, 0, 0, 0, 0, 0, 0, 0, 0, 0, 0, 0, 0, 0, 0, 0, 0, 0, 0, 0, 0, 0, 0, 0, 0, 0, 0, 0, 0, 0, 0, 0, 0, 0, 0, 0, 0, 0, 0, 0, 0, 0, 0, 0], 
[0, 0, 0, 0, 0, 0, 0, 804, 805, 804, 805, 0, 0, 0, 0, 0, 0, 0, 0, 0, 0, 0, 0, 0, 0, 0, 0, 0, 0, 0, 0, 0, 0, 0, 0, 0, 0, 0, 0, 0, 0, 0, 0, 0, 0, 0, 0, 0, 0, 0], 
[0, 0, 0, 0, 0, 0, 0, 0, 0, 0, 0, 0, 0, 0, 0, 0, 0, 0, 0, 0, 0, 0, 0, 0, 0, 0, 0, 0, 0, 0, 0, 0, 0, 0, 0, 0, 0, 0, 0, 0, 0, 0, 0, 0, 0, 0, 0, 0, 0, 0], 
[0, 0, 0, 0, 0, 0, 0, 0, 0, 0, 0, 0, 0, 0, 0, 0, 0, 0, 0, 0, 0, 0, 0, 0, 0, 0, 0, 0, 0, 0, 0, 0, 0, 0, 0, 0, 0, 0, 0, 0, 0, 0, 0, 0, 0, 0, 0, 0, 0, 0], 
[0, 0, 0, 0, 0, 0, 0, 0, 0, 0, 0, 0, 0, 0, 0, 0, 0, 0, 0, 0, 0, 0, 0, 0, 0, 0, 0, 0, 0, 0, 0, 0, 0, 0, 0, 0, 0, 0, 0, 0, 0, 0, 0, 0, 0, 0, 0, 0, 0, 0], 
[0, 0, 0, 0, 0, 0, 0, 0, 0, 0, 0, 804, 805, 0, 0, 0, 0, 0, 0, 0, 0, 0, 0, 0, 0, 0, 0, 0, 0, 0, 0, 0, 0, 0, 0, 0, 0, 0, 0, 0, 0, 804, 805, 0, 0, 0, 0, 0, 0, 0], 
[0, 0, 0, 0, 0, 0, 0, 0, 0, 0, 0, 0, 0, 0, 0, 0, 0, 0, 0, 0, 0, 0, 0, 0, 0, 0, 0, 0, 0, 0, 0, 0, 0, 0, 0, 0, 0, 0, 0, 0, 0, 0, 0, 0, 0, 0, 0, 0, 0, 0], 
[0, 0, 0, 0, 0, 0, 0, 0, 0, 0, 0, 0, 0, 804, 805, 0, 0, 0, 0, 0, 0, 0, 0, 0, 0, 0, 0, 0, 0, 0, 0, 0, 0, 0, 0, 0, 0, 0, 0, 804, 805, 0, 0, 0, 0, 0, 0, 0, 0, 0], 
[0, 0, 0, 0, 0, 0, 0, 0, 0, 0, 0, 0, 0, 0, 0, 0, 0, 0, 0, 0, 0, 0, 0, 0, 0, 0, 0, 0, 0, 0, 0, 0, 0, 0, 0, 0, 0, 0, 0, 0, 0, 0, 0, 0, 0, 0, 0, 0, 0, 0], 
[0, 0, 0, 0, 0, 0, 0, 0, 0, 0, 0, 0, 0, 0, 0, 804, 805, 0, 0, 0, 0, 0, 0, 0, 0, 0, 0, 0, 0, 0, 0, 0, 0, 0, 0, 0, 0, 804, 805, 0, 0, 0, 0, 0, 0, 0, 0, 0, 0, 0], 
[0, 0, 0, 0, 0, 0, 0, 0, 0, 0, 0, 0, 0, 0, 0, 0, 0, 0, 0, 0, 0, 0, 0, 0, 0, 0, 0, 0, 0, 0, 0, 0, 0, 0, 0, 0, 0, 0, 0, 0, 0, 0, 0, 0, 0, 0, 0, 0, 0, 0], 
[805, 804, 805, 0, 0, 0, 0, 0, 0, 0, 0, 0, 0, 0, 0, 0, 0, 804, 805, 804, 805, 0, 0, 0, 0, 0, 0, 0, 0, 0, 0, 0, 0, 804, 805, 804, 805, 0, 0, 0, 0, 0, 0, 0, 0, 0, 0, 0, 0, 0], 
[0, 0, 0, 0, 0, 0, 0, 0, 0, 0, 0, 0, 0, 0, 0, 0, 0, 0, 0, 0, 0, 0, 0, 0, 0, 0, 0, 0, 0, 0, 0, 0, 0, 0, 0, 0, 0, 0, 0, 0, 0, 0, 0, 0, 0, 0, 0, 0, 0, 0], 
[0, 0, 0, 0, 0, 0, 0, 0, 0, 0, 0, 0, 0, 0, 0, 0, 0, 0, 0, 0, 0, 804, 805, 804, 805, 804, 805, 804, 805, 804, 805, 804, 805, 0, 0, 0, 0, 0, 0, 0, 0, 0, 0, 0, 0, 0, 0, 0, 0, 0], 
[0, 0, 0, 0, 0, 0, 0, 0, 0, 0, 0, 0, 0, 0, 0, 0, 0, 0, 0, 0, 0, 0, 0, 0, 0, 0, 0, 0, 0, 0, 0, 0, 0, 0, 0, 0, 0, 0, 0, 0, 0, 0, 0, 0, 0, 0, 0, 0, 0, 0], 
[0, 0, 0, 0, 0, 0, 0, 0, 0, 0, 0, 0, 0, 0, 0, 0, 0, 0, 0, 0, 0, 0, 0, 0, 0, 0, 0, 0, 0, 0, 0, 0, 0, 0, 0, 0, 0, 0, 0, 0, 0, 0, 0, 0, 0, 0, 0, 0, 0, 0], 
[0, 0, 0, 0, 0, 0, 0, 0, 0, 0, 0, 0, 0, 0, 0, 0, 0, 0, 0, 0, 0, 0, 0, 0, 0, 0, 0, 0, 0, 0, 0, 0, 0, 0, 0, 0, 0, 0, 0, 0, 0, 0, 0, 0, 0, 0, 0, 0, 0, 0], 
[0, 0, 0, 0, 0, 0, 0, 0, 0, 0, 0, 0, 0, 0, 0, 0, 0, 0, 0, 0, 0, 0, 0, 0, 0, 0, 0, 0, 0, 0, 0, 0, 0, 0, 0, 0, 0, 0, 0, 0, 0, 0, 0, 0, 0, 0, 0, 0, 0, 0], 
[0, 0, 0, 0, 0, 0, 0, 0, 0, 0, 0, 0, 0, 0, 0, 0, 0, 0, 0, 0, 0, 0, 0, 0, 0, 0, 0, 0, 0, 0, 0, 0, 0, 0, 0, 0, 0, 0, 0, 0, 0, 0, 0, 0, 0, 0, 0, 0, 0, 0]]]
}
}
