{
	"Map": {
		"id": 35,
		"map_display_x": 0,
		"map_display_y": 0,
		"width": 35,
		"height": 40,
		"xsize": 35,
		"ysize": 40,
		"zsize": 3,
		"Name" : "Ingido Plateau",
		"Parent" : "",
		"Tileset" : "Outside",
		"BattleBack" : "",
		"Autoplay_bgm" : true,
		"BGM" : "battle1",
		"Autoplay_bgs" : false,
		"BGS" : "",
		"Encounter_list" : [],
		"Encounter_step" : 30,
		"table": [[[808, 811, 385, 1179, 1179, 1179, 810, 809, 808, 809, 808, 811, 385, 385, 385, 385, 385, 385, 385, 385, 385, 385, 385, 810, 809, 808, 809, 808, 811, 1181, 1181, 1181, 385, 810, 809], 
[800, 803, 385, 1179, 1179, 1179, 802, 801, 800, 801, 800, 803, 385, 385, 385, 385, 385, 385, 385, 385, 385, 385, 385, 802, 801, 800, 801, 800, 803, 1181, 1181, 1181, 385, 802, 801], 
[808, 811, 385, 1179, 1179, 1179, 810, 809, 808, 809, 808, 811, 385, 385, 385, 385, 385, 385, 385, 385, 385, 385, 385, 810, 809, 808, 809, 808, 811, 1181, 1181, 1181, 385, 810, 809], 
[800, 803, 385, 1179, 1179, 1179, 802, 801, 800, 801, 800, 803, 385, 385, 385, 385, 385, 385, 385, 385, 385, 385, 385, 802, 801, 800, 801, 800, 803, 1181, 1181, 1181, 385, 802, 801], 
[808, 811, 385, 1179, 1179, 1179, 810, 809, 808, 809, 808, 811, 385, 385, 385, 385, 385, 385, 385, 385, 385, 385, 385, 810, 809, 808, 809, 808, 811, 1181, 1181, 1181, 385, 810, 809], 
[800, 803, 385, 1179, 1179, 1179, 802, 801, 800, 801, 800, 803, 385, 385, 385, 385, 385, 385, 385, 385, 385, 385, 385, 802, 801, 800, 801, 800, 803, 1181, 1181, 1181, 385, 802, 801], 
[808, 811, 385, 1179, 1179, 1179, 810, 809, 808, 809, 808, 811, 385, 389, 386, 386, 388, 388, 385, 388, 388, 386, 388, 810, 809, 808, 809, 808, 811, 1181, 1181, 1181, 385, 810, 809], 
[800, 803, 385, 1179, 1179, 1179, 802, 801, 800, 801, 800, 803, 386, 388, 385, 387, 387, 388, 386, 386, 387, 385, 388, 802, 801, 800, 801, 800, 803, 1181, 1181, 1181, 385, 802, 801], 
[808, 811, 385, 1179, 1179, 1179, 810, 809, 808, 809, 808, 811, 387, 386, 385, 389, 385, 388, 387, 387, 386, 389, 387, 810, 809, 808, 809, 808, 811, 1181, 1181, 1181, 385, 810, 809], 
[800, 803, 385, 1179, 1179, 1179, 802, 801, 800, 803, 818, 819, 389, 387, 385, 386, 712, 713, 714, 388, 385, 388, 385, 818, 819, 802, 801, 800, 803, 1181, 1181, 1181, 385, 802, 801], 
[808, 811, 385, 1179, 1179, 1179, 810, 809, 808, 811, 388, 385, 388, 389, 385, 387, 720, 721, 722, 385, 389, 387, 388, 386, 389, 810, 809, 808, 811, 1181, 1181, 1181, 385, 810, 809], 
[800, 803, 385, 1179, 1179, 1179, 818, 819, 818, 819, 386, 389, 387, 385, 386, 389, 720, 721, 722, 388, 387, 386, 388, 389, 385, 818, 819, 818, 819, 1181, 1181, 1181, 385, 802, 801], 
[808, 811, 385, 1179, 1179, 1187, 1188, 1188, 1188, 1188, 1188, 1193, 389, 388, 385, 388, 728, 729, 730, 387, 388, 385, 387, 1192, 1188, 1188, 1188, 1188, 1188, 1189, 1181, 1181, 385, 810, 809], 
[800, 803, 385, 1179, 1179, 1177, 1177, 1177, 1177, 1177, 1177, 1179, 385, 386, 387, 386, 389, 387, 386, 385, 389, 387, 386, 1181, 1177, 1177, 1177, 1177, 1177, 1177, 1181, 1181, 385, 802, 801], 
[808, 811, 385, 1179, 1179, 1177, 1177, 1177, 1177, 1177, 1177, 1187, 1188, 1188, 1188, 1188, 1188, 1188, 1188, 1188, 1188, 1188, 1188, 1189, 1177, 1177, 1177, 1177, 1177, 1177, 1181, 1181, 385, 810, 809], 
[800, 803, 385, 1179, 1187, 1188, 1188, 1188, 1188, 1188, 1193, 1177, 1177, 1177, 1177, 1177, 1177, 1177, 1177, 1177, 1177, 1177, 1177, 1177, 1192, 1188, 1188, 1188, 1188, 1188, 1189, 1181, 385, 802, 801], 
[808, 811, 385, 1179, 1177, 1177, 1177, 1177, 1177, 1177, 1187, 1188, 1188, 1188, 1188, 1188, 1188, 1188, 1188, 1188, 1188, 1188, 1188, 1188, 1189, 1177, 1177, 1177, 1177, 1177, 1177, 1181, 385, 810, 809], 
[800, 803, 385, 1187, 1188, 1188, 1188, 1188, 1188, 1193, 1177, 1177, 1177, 1177, 1177, 1177, 1177, 1177, 1177, 1177, 1177, 1177, 1177, 1177, 1177, 1192, 1188, 1188, 1188, 1188, 1188, 1189, 385, 802, 801], 
[808, 811, 385, 1177, 1177, 1177, 1177, 1177, 1177, 1187, 1188, 1188, 1188, 1188, 1188, 1188, 1188, 1188, 1188, 1188, 1188, 1188, 1188, 1188, 1188, 1189, 1177, 1177, 1177, 1177, 1177, 1177, 385, 810, 809], 
[800, 803, 385, 385, 385, 385, 385, 385, 1193, 1177, 1177, 1177, 1177, 1177, 1177, 1177, 1177, 1177, 1177, 1177, 1177, 1177, 1177, 1177, 1177, 1177, 1192, 385, 385, 385, 385, 385, 385, 802, 801], 
[808, 811, 810, 811, 810, 811, 810, 811, 385, 385, 385, 385, 385, 385, 385, 1188, 1188, 1188, 1188, 1188, 385, 385, 385, 385, 385, 385, 385, 810, 811, 810, 811, 810, 811, 810, 809], 
[800, 801, 800, 801, 800, 801, 800, 803, 712, 713, 713, 713, 713, 713, 713, 713, 713, 713, 713, 713, 713, 713, 713, 713, 713, 713, 714, 802, 801, 800, 801, 800, 801, 800, 801], 
[808, 809, 808, 809, 808, 809, 808, 811, 720, 721, 721, 721, 721, 721, 721, 721, 721, 721, 721, 721, 721, 721, 721, 721, 721, 721, 722, 810, 809, 808, 809, 808, 809, 808, 809], 
[818, 819, 818, 819, 818, 819, 818, 819, 720, 721, 721, 721, 721, 721, 721, 721, 721, 721, 721, 721, 721, 721, 721, 721, 721, 721, 722, 818, 819, 818, 819, 818, 819, 818, 819], 
[385, 387, 286, 389, 286, 386, 286, 387, 720, 721, 721, 721, 721, 721, 721, 721, 721, 721, 721, 721, 721, 721, 721, 721, 721, 721, 722, 385, 286, 386, 286, 387, 286, 388, 389], 
[386, 389, 385, 387, 386, 385, 388, 387, 720, 721, 721, 721, 721, 721, 721, 721, 721, 721, 721, 721, 721, 721, 721, 721, 721, 721, 722, 537, 538, 538, 538, 538, 538, 538, 538], 
[385, 388, 386, 385, 388, 386, 386, 388, 720, 721, 721, 721, 721, 721, 721, 721, 721, 721, 721, 721, 721, 721, 721, 721, 721, 721, 722, 553, 554, 554, 554, 554, 554, 554, 554], 
[388, 387, 286, 389, 286, 387, 286, 385, 720, 721, 721, 721, 721, 721, 721, 721, 721, 721, 721, 721, 721, 721, 721, 721, 721, 721, 722, 388, 286, 387, 286, 385, 286, 386, 389], 
[810, 811, 810, 811, 810, 811, 810, 811, 720, 721, 721, 721, 721, 721, 721, 721, 721, 721, 721, 721, 721, 721, 721, 721, 721, 721, 722, 810, 811, 810, 811, 810, 811, 810, 811], 
[800, 801, 800, 801, 800, 801, 800, 803, 728, 729, 729, 729, 729, 729, 729, 729, 729, 729, 729, 729, 729, 729, 729, 729, 729, 729, 730, 802, 801, 800, 801, 800, 801, 800, 801], 
[808, 809, 808, 809, 808, 809, 808, 811, 810, 811, 810, 811, 386, 385, 387, 386, 388, 387, 385, 386, 388, 387, 387, 810, 811, 810, 811, 810, 809, 808, 809, 808, 809, 808, 809], 
[800, 801, 800, 801, 800, 801, 800, 801, 800, 801, 800, 803, 385, 385, 385, 385, 385, 385, 385, 385, 385, 385, 385, 802, 801, 800, 801, 800, 801, 800, 801, 800, 801, 800, 801], 
[808, 809, 808, 809, 808, 809, 808, 809, 808, 809, 808, 811, 385, 385, 385, 385, 385, 385, 385, 385, 385, 385, 385, 810, 809, 808, 809, 808, 809, 808, 809, 808, 809, 808, 809], 
[800, 801, 800, 801, 800, 801, 800, 801, 800, 801, 800, 803, 385, 385, 385, 385, 385, 385, 385, 385, 385, 385, 385, 802, 801, 800, 801, 800, 801, 800, 801, 800, 801, 800, 801], 
[808, 809, 808, 809, 808, 809, 808, 809, 808, 809, 808, 811, 385, 385, 385, 385, 385, 385, 385, 385, 385, 385, 385, 810, 809, 808, 809, 808, 809, 808, 809, 808, 809, 808, 809], 
[800, 801, 800, 801, 800, 801, 800, 801, 800, 801, 800, 803, 385, 720, 721, 721, 721, 721, 721, 721, 721, 722, 385, 802, 801, 800, 801, 800, 801, 800, 801, 800, 801, 800, 801], 
[808, 809, 808, 809, 808, 809, 808, 809, 808, 809, 808, 811, 385, 720, 721, 721, 721, 721, 721, 721, 721, 722, 385, 810, 809, 808, 809, 808, 809, 808, 809, 808, 809, 808, 809], 
[800, 801, 800, 801, 800, 801, 800, 801, 800, 801, 800, 803, 385, 720, 721, 721, 721, 721, 721, 721, 721, 722, 385, 802, 801, 800, 801, 800, 801, 800, 801, 800, 801, 800, 801], 
[808, 809, 808, 809, 808, 809, 808, 809, 808, 809, 808, 811, 385, 720, 721, 721, 721, 721, 721, 721, 721, 722, 385, 810, 809, 808, 809, 808, 809, 808, 809, 808, 809, 808, 809], 
[800, 801, 800, 801, 800, 801, 800, 801, 800, 801, 800, 803, 385, 720, 721, 721, 721, 721, 721, 721, 721, 722, 385, 802, 801, 800, 801, 800, 801, 800, 801, 800, 801, 800, 801]], 

[[0, 0, 1176, 0, 0, 0, 0, 0, 0, 0, 0, 0, 3520, 3521, 3522, 3522, 3523, 3524, 3525, 3522, 3522, 3526, 3527, 0, 0, 0, 0, 0, 0, 0, 0, 0, 1178, 0, 0], 
[0, 0, 1176, 0, 0, 0, 0, 0, 0, 0, 0, 0, 3520, 3521, 3522, 3522, 3523, 3524, 3525, 3522, 3522, 3526, 3527, 0, 0, 0, 0, 0, 0, 0, 0, 0, 1178, 0, 0], 
[0, 0, 1176, 0, 0, 0, 0, 0, 0, 0, 0, 0, 3520, 3521, 3522, 3522, 3523, 3524, 3525, 3522, 3522, 3526, 3527, 0, 0, 0, 0, 0, 0, 0, 0, 0, 1178, 0, 0], 
[0, 0, 1176, 0, 0, 0, 0, 0, 0, 0, 0, 0, 3528, 3529, 3530, 3530, 3531, 3532, 3533, 3530, 3530, 3534, 3535, 0, 0, 0, 0, 0, 0, 0, 0, 0, 1178, 0, 0], 
[0, 0, 1176, 0, 0, 0, 0, 0, 0, 0, 0, 0, 3536, 3537, 3538, 3538, 3539, 3540, 3541, 3538, 3538, 3542, 3543, 0, 0, 0, 0, 0, 0, 0, 0, 0, 1178, 0, 0], 
[0, 0, 1176, 0, 0, 0, 0, 0, 0, 0, 0, 0, 3544, 3545, 3546, 3546, 3547, 3548, 3549, 3546, 3546, 3550, 3551, 0, 0, 0, 0, 0, 0, 0, 0, 0, 1178, 0, 0], 
[0, 0, 1176, 0, 0, 0, 0, 0, 0, 0, 0, 0, 3552, 3553, 3554, 3554, 3555, 3556, 3557, 3554, 3554, 3558, 3559, 0, 0, 0, 0, 0, 0, 0, 0, 0, 1178, 0, 0], 
[0, 0, 1176, 0, 0, 0, 0, 0, 0, 0, 0, 0, 0, 1342, 0, 0, 3563, 3564, 3565, 0, 0, 1342, 0, 0, 0, 0, 0, 0, 0, 0, 0, 0, 1178, 0, 0], 
[0, 0, 1176, 0, 0, 0, 0, 0, 0, 0, 0, 0, 1342, 0, 0, 0, 3571, 3572, 3573, 0, 0, 0, 1342, 0, 0, 0, 0, 0, 0, 0, 0, 0, 1178, 0, 0], 
[0, 0, 1176, 0, 0, 0, 0, 0, 0, 0, 0, 0, 1342, 0, 1350, 0, 0, 0, 0, 0, 1350, 0, 1342, 0, 0, 0, 0, 0, 0, 0, 0, 0, 1178, 0, 0], 
[0, 0, 1176, 0, 0, 0, 0, 0, 0, 0, 0, 0, 1342, 0, 1358, 0, 0, 0, 0, 0, 1358, 0, 1342, 0, 0, 0, 0, 0, 0, 0, 0, 0, 1178, 0, 0], 
[0, 0, 1176, 0, 0, 0, 0, 0, 0, 0, 0, 0, 1342, 0, 0, 0, 0, 0, 0, 0, 0, 0, 1342, 0, 0, 0, 0, 0, 0, 0, 0, 0, 1178, 0, 0], 
[0, 0, 1176, 0, 0, 0, 0, 0, 0, 0, 0, 0, 0, 1342, 1350, 0, 0, 0, 0, 0, 1350, 1342, 0, 0, 0, 0, 0, 0, 0, 0, 0, 0, 1178, 0, 0], 
[0, 0, 1176, 0, 0, 0, 0, 0, 0, 0, 0, 0, 0, 0, 1358, 4336, 4337, 4338, 4339, 4340, 1358, 0, 0, 0, 0, 0, 0, 0, 0, 0, 0, 0, 1178, 0, 0], 
[0, 0, 1176, 0, 0, 0, 0, 0, 0, 0, 0, 0, 0, 0, 0, 4344, 4345, 4346, 4347, 4348, 0, 0, 0, 0, 0, 0, 0, 0, 0, 0, 0, 0, 1178, 0, 0], 
[0, 0, 1176, 0, 0, 0, 0, 0, 0, 0, 0, 0, 0, 0, 0, 4352, 4353, 4354, 4355, 4356, 0, 0, 0, 0, 0, 0, 0, 0, 0, 0, 0, 0, 1178, 0, 0], 
[0, 0, 1176, 0, 0, 0, 0, 0, 0, 0, 0, 0, 0, 0, 0, 4360, 4345, 4346, 4347, 4364, 0, 0, 0, 0, 0, 0, 0, 0, 0, 0, 0, 0, 1178, 0, 0], 
[0, 0, 1176, 0, 0, 0, 0, 0, 0, 0, 0, 0, 0, 0, 0, 4320, 4353, 4354, 4355, 4324, 0, 0, 0, 0, 0, 0, 0, 0, 0, 0, 0, 0, 1178, 0, 0], 
[0, 0, 1176, 0, 0, 0, 0, 0, 0, 0, 0, 0, 0, 0, 0, 4344, 4361, 4362, 4363, 4348, 0, 0, 0, 0, 0, 0, 0, 0, 0, 0, 0, 0, 1178, 0, 0], 
[0, 0, 1184, 1185, 1185, 1185, 1185, 1185, 0, 0, 0, 0, 0, 0, 0, 4352, 4369, 4370, 4371, 4356, 0, 0, 0, 0, 0, 0, 0, 1185, 1185, 1185, 1185, 1185, 1186, 0, 0], 
[0, 0, 0, 0, 0, 0, 0, 0, 1184, 1185, 1185, 1185, 1185, 1185, 1185, 4376, 4377, 4378, 4379, 4380, 1185, 1185, 1185, 1185, 1185, 1185, 1186, 0, 0, 0, 0, 0, 0, 0, 0], 
[0, 0, 0, 0, 0, 0, 0, 0, 0, 0, 0, 0, 0, 0, 0, 4384, 4385, 4386, 4387, 4388, 0, 0, 0, 0, 0, 0, 0, 0, 0, 0, 0, 0, 0, 0, 0], 
[0, 0, 0, 0, 0, 0, 0, 0, 1342, 0, 1342, 0, 1342, 0, 1342, 0, 0, 0, 0, 0, 1342, 0, 1342, 0, 1342, 0, 1342, 0, 0, 0, 0, 0, 0, 0, 0], 
[0, 0, 0, 0, 0, 0, 0, 0, 1342, 1342, 0, 1342, 0, 1342, 0, 0, 0, 0, 0, 0, 0, 1342, 0, 1342, 0, 1342, 1342, 0, 0, 0, 0, 0, 0, 0, 0], 
[0, 0, 0, 0, 0, 0, 0, 0, 0, 0, 0, 0, 0, 0, 0, 0, 0, 0, 0, 0, 0, 0, 0, 0, 0, 0, 0, 0, 0, 0, 0, 0, 0, 0, 0], 
[0, 0, 0, 0, 0, 0, 0, 0, 0, 0, 0, 0, 0, 0, 0, 0, 0, 0, 0, 0, 0, 0, 0, 0, 0, 0, 0, 0, 0, 0, 0, 0, 0, 0, 0], 
[0, 0, 0, 0, 0, 0, 0, 0, 0, 0, 0, 0, 0, 0, 0, 0, 0, 0, 0, 0, 0, 0, 0, 0, 0, 0, 0, 0, 0, 0, 0, 0, 0, 0, 0], 
[0, 0, 0, 0, 0, 0, 0, 0, 0, 0, 0, 0, 0, 0, 0, 0, 0, 0, 0, 0, 0, 0, 0, 0, 0, 0, 0, 0, 0, 0, 0, 0, 0, 0, 0], 
[0, 0, 0, 0, 0, 0, 0, 0, 1342, 0, 1342, 0, 1342, 0, 1342, 0, 1342, 0, 1342, 0, 1342, 0, 1342, 0, 1342, 0, 1342, 0, 0, 0, 0, 0, 0, 0, 0], 
[0, 0, 0, 0, 0, 0, 0, 0, 1342, 1342, 0, 1342, 0, 1342, 0, 1342, 0, 1342, 0, 1342, 0, 1342, 0, 1342, 0, 1342, 1342, 0, 0, 0, 0, 0, 0, 0, 0], 
[0, 0, 0, 0, 0, 0, 0, 0, 0, 0, 0, 0, 4280, 4281, 4282, 4280, 4281, 4282, 4282, 4280, 4281, 4282, 4280, 0, 0, 0, 0, 0, 0, 0, 0, 0, 0, 0, 0], 
[0, 0, 0, 0, 0, 0, 0, 0, 0, 0, 0, 0, 4288, 4289, 4290, 4288, 4289, 4290, 4290, 4288, 4289, 4290, 4288, 0, 0, 0, 0, 0, 0, 0, 0, 0, 0, 0, 0], 
[0, 0, 0, 0, 0, 0, 0, 0, 0, 0, 0, 0, 4288, 4289, 4290, 4288, 4289, 4290, 4290, 4288, 4289, 4290, 4288, 0, 0, 0, 0, 0, 0, 0, 0, 0, 0, 0, 0], 
[0, 0, 0, 0, 0, 0, 0, 0, 0, 0, 0, 0, 4288, 4289, 4290, 4288, 4289, 4290, 4290, 4288, 4289, 4290, 4288, 0, 0, 0, 0, 0, 0, 0, 0, 0, 0, 0, 0], 
[0, 0, 0, 0, 0, 0, 0, 0, 0, 0, 0, 0, 4296, 4297, 4303, 4296, 4300, 4301, 4301, 4296, 4297, 4298, 4296, 0, 0, 0, 0, 0, 0, 0, 0, 0, 0, 0, 0], 
[0, 0, 0, 0, 0, 0, 0, 0, 0, 0, 0, 0, 4307, 4305, 4311, 4307, 4308, 4309, 4309, 4307, 4305, 4306, 4307, 0, 0, 0, 0, 0, 0, 0, 0, 0, 0, 0, 0], 
[0, 0, 0, 0, 0, 0, 0, 0, 0, 0, 0, 0, 4315, 0, 0, 4315, 0, 0, 0, 4315, 0, 0, 4315, 0, 0, 0, 0, 0, 0, 0, 0, 0, 0, 0, 0], 
[0, 0, 0, 0, 0, 0, 0, 0, 0, 0, 0, 0, 0, 0, 0, 0, 0, 0, 0, 0, 0, 0, 0, 0, 0, 0, 0, 0, 0, 0, 0, 0, 0, 0, 0], 
[0, 0, 0, 0, 0, 0, 0, 0, 0, 0, 0, 0, 0, 0, 0, 0, 0, 0, 0, 0, 0, 0, 0, 0, 0, 0, 0, 0, 0, 0, 0, 0, 0, 0, 0], 
[0, 0, 0, 0, 0, 0, 0, 0, 0, 0, 0, 0, 0, 0, 0, 0, 0, 0, 0, 0, 0, 0, 0, 0, 0, 0, 0, 0, 0, 0, 0, 0, 0, 0, 0]], 

[[0, 0, 0, 0, 0, 0, 0, 0, 0, 0, 0, 0, 0, 0, 0, 0, 0, 0, 0, 0, 0, 0, 0, 0, 0, 0, 0, 0, 0, 0, 0, 0, 0, 0, 0], 
[0, 0, 0, 0, 0, 0, 0, 0, 0, 0, 0, 0, 0, 0, 0, 0, 0, 0, 0, 0, 0, 0, 0, 0, 0, 0, 0, 0, 0, 0, 0, 0, 0, 0, 0], 
[0, 0, 0, 0, 0, 0, 0, 0, 0, 0, 0, 0, 0, 0, 0, 0, 0, 0, 0, 0, 0, 0, 0, 0, 0, 0, 0, 0, 0, 0, 0, 0, 0, 0, 0], 
[0, 0, 0, 0, 0, 0, 0, 0, 0, 0, 0, 0, 0, 0, 0, 0, 0, 0, 0, 0, 0, 0, 0, 0, 0, 0, 0, 0, 0, 0, 0, 0, 0, 0, 0], 
[0, 0, 0, 0, 0, 0, 0, 0, 0, 0, 0, 0, 0, 878, 0, 878, 0, 0, 0, 878, 0, 878, 0, 0, 0, 0, 0, 0, 0, 0, 0, 0, 0, 0, 0], 
[0, 0, 0, 0, 0, 0, 0, 0, 0, 0, 0, 0, 0, 886, 0, 886, 0, 0, 0, 886, 0, 886, 0, 0, 0, 0, 0, 0, 0, 0, 0, 0, 0, 0, 0], 
[0, 0, 0, 0, 0, 0, 0, 0, 0, 0, 0, 0, 0, 894, 1350, 894, 0, 0, 0, 894, 1350, 894, 0, 0, 0, 0, 0, 0, 0, 0, 0, 0, 0, 0, 0], 
[0, 0, 0, 0, 0, 0, 0, 0, 0, 0, 0, 0, 0, 0, 1358, 0, 0, 0, 0, 0, 1358, 0, 0, 0, 0, 0, 0, 0, 0, 0, 0, 0, 0, 0, 0], 
[0, 0, 0, 0, 0, 0, 0, 0, 0, 0, 0, 0, 0, 0, 0, 0, 0, 0, 0, 0, 0, 0, 0, 0, 0, 0, 0, 0, 0, 0, 0, 0, 0, 0, 0], 
[0, 0, 0, 0, 0, 0, 0, 0, 0, 0, 0, 0, 0, 0, 0, 0, 0, 0, 0, 0, 0, 0, 0, 0, 0, 0, 0, 0, 0, 0, 0, 0, 0, 0, 0], 
[0, 0, 0, 0, 0, 0, 0, 0, 0, 0, 0, 0, 0, 0, 0, 0, 0, 0, 0, 0, 0, 0, 0, 0, 0, 0, 0, 0, 0, 0, 0, 0, 0, 0, 0], 
[0, 0, 0, 0, 0, 0, 0, 0, 0, 0, 0, 0, 0, 0, 0, 0, 0, 0, 0, 0, 0, 0, 0, 0, 0, 0, 0, 0, 0, 0, 0, 0, 0, 0, 0], 
[0, 0, 0, 0, 0, 0, 0, 0, 0, 0, 0, 0, 0, 0, 0, 0, 0, 0, 0, 0, 0, 0, 0, 0, 0, 0, 0, 0, 0, 0, 0, 0, 0, 0, 0], 
[0, 0, 0, 0, 0, 0, 0, 0, 0, 0, 0, 0, 0, 0, 0, 0, 4321, 4322, 4323, 0, 0, 0, 0, 0, 0, 0, 0, 0, 0, 0, 0, 0, 0, 0, 0], 
[0, 0, 0, 0, 0, 0, 0, 0, 0, 0, 0, 0, 0, 0, 0, 0, 4329, 4330, 4331, 0, 0, 0, 0, 0, 0, 0, 0, 0, 0, 0, 0, 0, 0, 0, 0], 
[0, 0, 0, 0, 0, 0, 0, 0, 0, 0, 0, 0, 0, 0, 0, 0, 0, 0, 0, 0, 0, 0, 0, 0, 0, 0, 0, 0, 0, 0, 0, 0, 0, 0, 0], 
[0, 0, 0, 0, 0, 0, 0, 0, 0, 0, 0, 0, 0, 0, 0, 0, 0, 0, 0, 0, 0, 0, 0, 0, 0, 0, 0, 0, 0, 0, 0, 0, 0, 0, 0], 
[0, 0, 0, 0, 0, 0, 0, 0, 0, 0, 0, 0, 0, 0, 0, 0, 4321, 4322, 4323, 0, 0, 0, 0, 0, 0, 0, 0, 0, 0, 0, 0, 0, 0, 0, 0], 
[0, 0, 0, 0, 0, 0, 0, 0, 0, 0, 0, 0, 0, 0, 0, 0, 4329, 4330, 4331, 0, 0, 0, 0, 0, 0, 0, 0, 0, 0, 0, 0, 0, 0, 0, 0], 
[0, 0, 804, 805, 804, 805, 804, 805, 0, 0, 0, 0, 0, 0, 0, 0, 0, 0, 0, 0, 0, 0, 0, 0, 0, 0, 0, 804, 805, 804, 805, 804, 805, 0, 0], 
[0, 0, 0, 0, 0, 0, 0, 0, 0, 1350, 0, 1350, 0, 1350, 0, 0, 0, 0, 0, 0, 0, 1350, 0, 1350, 0, 1350, 0, 0, 0, 0, 0, 0, 0, 0, 0], 
[0, 0, 0, 0, 0, 0, 0, 0, 0, 1358, 0, 1358, 0, 1358, 0, 0, 0, 0, 0, 0, 0, 1358, 0, 1358, 0, 1358, 0, 0, 0, 0, 0, 0, 0, 0, 0], 
[0, 0, 0, 0, 0, 0, 0, 0, 0, 0, 0, 0, 0, 0, 0, 0, 0, 0, 0, 0, 0, 0, 0, 0, 0, 0, 0, 0, 0, 0, 0, 0, 0, 0, 0], 
[0, 0, 0, 0, 0, 0, 0, 0, 0, 0, 0, 0, 0, 0, 0, 0, 0, 0, 0, 0, 0, 0, 0, 0, 0, 0, 0, 0, 0, 0, 0, 0, 0, 0, 0], 
[0, 0, 0, 0, 0, 0, 0, 0, 0, 0, 0, 0, 0, 0, 0, 0, 0, 0, 0, 0, 0, 0, 0, 0, 0, 0, 0, 0, 0, 0, 0, 0, 0, 0, 0], 
[0, 0, 0, 0, 0, 0, 0, 0, 0, 0, 0, 0, 0, 0, 0, 0, 0, 0, 0, 0, 0, 0, 0, 0, 0, 0, 0, 0, 0, 0, 0, 0, 0, 0, 0], 
[0, 0, 0, 0, 0, 0, 0, 0, 0, 0, 0, 0, 0, 0, 0, 0, 0, 0, 0, 0, 0, 0, 0, 0, 0, 0, 0, 0, 0, 0, 0, 0, 0, 0, 0], 
[804, 805, 804, 805, 804, 805, 804, 805, 0, 0, 0, 0, 0, 0, 0, 0, 0, 0, 0, 0, 0, 0, 0, 0, 0, 0, 0, 804, 805, 804, 805, 804, 805, 804, 805], 
[0, 0, 0, 0, 0, 0, 0, 0, 0, 0, 0, 0, 0, 0, 0, 0, 0, 0, 0, 0, 0, 0, 0, 0, 0, 0, 0, 0, 0, 0, 0, 0, 0, 0, 0], 
[0, 0, 0, 0, 0, 0, 0, 0, 804, 805, 804, 805, 0, 0, 0, 0, 0, 0, 0, 0, 0, 0, 0, 804, 805, 804, 805, 0, 0, 0, 0, 0, 0, 0, 0], 
[0, 0, 0, 0, 0, 0, 0, 0, 0, 0, 0, 0, 0, 0, 0, 0, 0, 0, 0, 0, 0, 0, 0, 0, 0, 0, 0, 0, 0, 0, 0, 0, 0, 0, 0], 
[0, 0, 0, 0, 0, 0, 0, 0, 0, 0, 0, 0, 0, 0, 0, 0, 0, 0, 0, 0, 0, 0, 0, 0, 0, 0, 0, 0, 0, 0, 0, 0, 0, 0, 0], 
[0, 0, 0, 0, 0, 0, 0, 0, 0, 0, 0, 0, 0, 0, 0, 0, 0, 0, 0, 0, 0, 0, 0, 0, 0, 0, 0, 0, 0, 0, 0, 0, 0, 0, 0], 
[0, 0, 0, 0, 0, 0, 0, 0, 0, 0, 0, 0, 0, 0, 0, 0, 0, 0, 0, 0, 0, 0, 0, 0, 0, 0, 0, 0, 0, 0, 0, 0, 0, 0, 0], 
[0, 0, 0, 0, 0, 0, 0, 0, 0, 0, 0, 0, 0, 0, 0, 0, 0, 0, 0, 0, 0, 0, 0, 0, 0, 0, 0, 0, 0, 0, 0, 0, 0, 0, 0], 
[0, 0, 0, 0, 0, 0, 0, 0, 0, 0, 0, 0, 0, 0, 0, 0, 0, 0, 0, 0, 0, 0, 0, 0, 0, 0, 0, 0, 0, 0, 0, 0, 0, 0, 0], 
[0, 0, 0, 0, 0, 0, 0, 0, 0, 0, 0, 0, 0, 0, 0, 0, 0, 0, 0, 0, 0, 0, 0, 0, 0, 0, 0, 0, 0, 0, 0, 0, 0, 0, 0], 
[0, 0, 0, 0, 0, 0, 0, 0, 0, 0, 0, 0, 0, 0, 0, 0, 0, 0, 0, 0, 0, 0, 0, 0, 0, 0, 0, 0, 0, 0, 0, 0, 0, 0, 0], 
[0, 0, 0, 0, 0, 0, 0, 0, 0, 0, 0, 0, 0, 0, 0, 0, 0, 0, 0, 0, 0, 0, 0, 0, 0, 0, 0, 0, 0, 0, 0, 0, 0, 0, 0], 
[0, 0, 0, 0, 0, 0, 0, 0, 0, 0, 0, 0, 0, 0, 0, 0, 0, 0, 0, 0, 0, 0, 0, 0, 0, 0, 0, 0, 0, 0, 0, 0, 0, 0, 0]]]
}
}
