{
	"Map": {
		"id": 39,
		"map_display_x": 0,
		"map_display_y": 0,
		"width": 44,
		"height": 23,
		"xsize": 44,
		"ysize": 23,
		"zsize": 3,
		"Name" : "Route 4",
		"Parent" : "",
		"Tileset" : "Outside",
		"BattleBack" : "",
		"Autoplay_bgm" : true,
		"BGM" : "route",
		"Autoplay_bgs" : false,
		"BGS" : "",
		"Encounter_list" : [],
		"Encounter_step" : 30,
		"table": [[[385, 385, 385, 385, 385, 385, 385, 385, 802, 801, 800, 801, 800, 801, 800, 801, 800, 801, 800, 801, 800, 801, 800, 801, 800, 801, 800, 801, 800, 801, 800, 801, 800, 801, 800, 801, 800, 801, 800, 801, 800, 801, 800, 801], 
[385, 385, 385, 385, 385, 385, 385, 385, 810, 809, 808, 809, 808, 809, 808, 809, 808, 809, 808, 809, 808, 809, 808, 809, 808, 809, 808, 809, 808, 809, 808, 809, 808, 809, 808, 809, 808, 809, 808, 809, 808, 809, 808, 809], 
[385, 385, 385, 385, 385, 385, 385, 385, 802, 801, 800, 801, 800, 801, 800, 801, 800, 801, 800, 801, 800, 801, 800, 801, 800, 801, 800, 801, 800, 801, 800, 801, 800, 801, 800, 801, 800, 801, 800, 801, 800, 801, 800, 801], 
[385, 385, 385, 385, 385, 385, 385, 385, 810, 809, 808, 809, 808, 809, 808, 809, 808, 809, 808, 809, 808, 809, 808, 809, 808, 809, 808, 809, 808, 809, 808, 809, 808, 809, 808, 809, 808, 809, 808, 809, 808, 809, 808, 809], 
[385, 385, 385, 385, 385, 385, 134, 1232, 818, 819, 818, 819, 818, 819, 818, 819, 818, 819, 818, 819, 818, 819, 818, 819, 818, 819, 818, 819, 818, 819, 818, 819, 818, 819, 818, 819, 818, 819, 818, 819, 802, 801, 800, 801], 
[385, 385, 385, 385, 385, 385, 385, 385, 385, 385, 385, 385, 385, 385, 385, 385, 385, 385, 385, 385, 385, 385, 385, 385, 385, 385, 385, 385, 385, 385, 385, 385, 385, 385, 385, 385, 385, 385, 385, 385, 810, 809, 808, 809], 
[385, 385, 385, 385, 385, 385, 385, 386, 388, 537, 538, 539, 385, 385, 385, 385, 385, 537, 538, 538, 538, 538, 538, 538, 538, 539, 388, 385, 389, 387, 390, 390, 390, 390, 390, 390, 390, 390, 390, 387, 802, 801, 800, 801], 
[385, 385, 385, 385, 385, 385, 385, 389, 385, 545, 546, 556, 538, 538, 538, 538, 538, 558, 546, 546, 546, 546, 546, 546, 546, 547, 386, 387, 386, 385, 390, 390, 390, 390, 390, 390, 390, 390, 390, 386, 810, 809, 808, 809], 
[385, 385, 385, 385, 385, 385, 385, 386, 387, 545, 546, 546, 546, 546, 546, 546, 546, 546, 546, 546, 540, 554, 554, 554, 554, 555, 385, 389, 388, 386, 390, 390, 390, 390, 390, 390, 390, 390, 390, 388, 802, 801, 800, 801], 
[385, 385, 385, 385, 385, 385, 385, 385, 388, 553, 554, 554, 554, 554, 554, 554, 554, 554, 554, 554, 555, 385, 388, 386, 385, 389, 387, 386, 385, 387, 385, 386, 388, 385, 387, 386, 385, 389, 385, 386, 810, 809, 808, 809], 
[385, 385, 385, 385, 385, 385, 385, 387, 386, 385, 388, 386, 385, 387, 389, 385, 386, 387, 385, 386, 385, 388, 387, 385, 388, 386, 385, 386, 388, 385, 389, 385, 386, 387, 385, 388, 387, 386, 387, 385, 802, 801, 800, 801], 
[385, 385, 385, 385, 385, 385, 385, 385, 385, 385, 385, 385, 385, 385, 385, 385, 385, 385, 385, 385, 385, 385, 385, 385, 385, 385, 385, 385, 385, 385, 385, 385, 385, 385, 385, 385, 389, 386, 385, 388, 810, 809, 808, 809], 
[385, 385, 385, 385, 385, 385, 385, 387, 386, 385, 388, 386, 385, 388, 389, 386, 385, 388, 386, 389, 385, 386, 387, 388, 385, 385, 385, 385, 385, 385, 385, 385, 385, 385, 385, 388, 385, 387, 389, 386, 818, 819, 818, 819], 
[385, 385, 385, 385, 385, 385, 385, 385, 389, 537, 538, 539, 389, 386, 385, 387, 537, 538, 538, 538, 538, 538, 538, 538, 538, 538, 538, 538, 538, 538, 538, 538, 538, 539, 387, 387, 386, 388, 385, 387, 385, 389, 387, 386], 
[385, 385, 385, 385, 385, 385, 385, 386, 388, 545, 546, 547, 385, 387, 388, 385, 545, 546, 546, 546, 546, 546, 546, 546, 546, 546, 546, 546, 546, 546, 546, 546, 546, 547, 385, 386, 385, 387, 386, 389, 388, 386, 385, 389], 
[385, 385, 385, 385, 385, 385, 385, 389, 385, 545, 546, 547, 386, 389, 386, 387, 545, 546, 546, 546, 540, 554, 554, 554, 554, 554, 554, 554, 554, 554, 554, 554, 554, 555, 388, 387, 389, 385, 387, 385, 388, 385, 386, 387], 
[385, 385, 385, 385, 385, 385, 385, 385, 386, 545, 546, 547, 388, 385, 388, 385, 545, 546, 546, 546, 547, 385, 385, 385, 385, 385, 385, 385, 385, 385, 385, 385, 385, 385, 385, 385, 385, 385, 385, 385, 386, 387, 389, 385], 
[385, 385, 385, 385, 385, 385, 385, 386, 387, 545, 546, 547, 386, 387, 385, 386, 545, 546, 546, 546, 547, 385, 810, 811, 810, 811, 810, 811, 810, 811, 810, 811, 810, 811, 810, 811, 810, 811, 810, 811, 810, 811, 810, 811], 
[385, 385, 385, 385, 385, 385, 385, 388, 385, 545, 546, 556, 538, 538, 538, 538, 558, 546, 546, 546, 547, 387, 802, 801, 800, 801, 800, 801, 800, 801, 800, 801, 800, 801, 800, 801, 800, 801, 800, 801, 800, 801, 800, 801], 
[385, 385, 385, 385, 385, 385, 385, 386, 389, 545, 546, 546, 546, 546, 546, 546, 546, 546, 546, 546, 547, 386, 810, 809, 808, 809, 808, 809, 808, 809, 808, 809, 808, 809, 808, 809, 808, 809, 808, 809, 808, 809, 808, 809], 
[385, 385, 385, 385, 385, 385, 385, 387, 385, 545, 546, 540, 554, 554, 554, 554, 542, 546, 540, 554, 555, 385, 802, 801, 800, 801, 800, 801, 800, 801, 800, 801, 800, 801, 800, 801, 800, 801, 800, 801, 800, 801, 800, 801], 
[385, 385, 385, 385, 385, 385, 385, 388, 386, 781, 782, 783, 385, 389, 386, 388, 781, 782, 783, 386, 388, 389, 810, 809, 808, 809, 808, 809, 808, 809, 808, 809, 808, 809, 808, 809, 808, 809, 808, 809, 808, 809, 808, 809], 
[385, 385, 385, 385, 385, 385, 385, 385, 389, 789, 790, 791, 388, 385, 387, 385, 789, 790, 791, 385, 387, 386, 818, 819, 818, 819, 818, 819, 818, 819, 818, 819, 818, 819, 818, 819, 818, 819, 818, 819, 802, 801, 800, 801]], 

[[144, 144, 144, 144, 144, 144, 168, 72, 0, 0, 0, 0, 0, 0, 0, 0, 0, 0, 0, 0, 0, 0, 0, 0, 0, 0, 0, 0, 0, 0, 0, 0, 0, 0, 0, 0, 0, 0, 0, 0, 0, 0, 0, 0], 
[144, 144, 144, 144, 144, 144, 168, 72, 0, 0, 0, 0, 0, 0, 0, 0, 0, 0, 0, 0, 0, 0, 0, 0, 0, 0, 0, 0, 0, 0, 0, 0, 0, 0, 0, 0, 0, 0, 0, 0, 0, 0, 0, 0], 
[144, 144, 144, 144, 144, 148, 182, 72, 0, 0, 0, 0, 0, 0, 0, 0, 0, 0, 0, 0, 0, 0, 0, 0, 0, 0, 0, 0, 0, 0, 0, 0, 0, 0, 0, 0, 0, 0, 0, 0, 0, 0, 0, 0], 
[144, 144, 144, 144, 144, 168, 52, 86, 0, 0, 0, 0, 0, 0, 0, 0, 0, 0, 0, 0, 0, 0, 0, 0, 0, 0, 0, 0, 0, 0, 0, 0, 0, 0, 0, 0, 0, 0, 0, 0, 0, 0, 0, 0], 
[144, 144, 144, 144, 144, 168, 0, 0, 0, 0, 0, 0, 2048, 2049, 2050, 2050, 2051, 0, 0, 0, 0, 0, 0, 0, 0, 0, 0, 0, 0, 0, 0, 0, 0, 0, 0, 0, 0, 0, 0, 0, 0, 0, 0, 0], 
[144, 144, 144, 144, 144, 168, 72, 1658, 1681, 1681, 1681, 1681, 2056, 2058, 2058, 2058, 2059, 1681, 1681, 1681, 1681, 1681, 1681, 1681, 1681, 1681, 1681, 1681, 1681, 1681, 1681, 1681, 1681, 1681, 1681, 1681, 1681, 1681, 1681, 1661, 0, 0, 0, 0], 
[144, 144, 144, 144, 144, 168, 72, 1664, 0, 0, 0, 0, 2064, 2066, 2066, 2066, 2067, 0, 0, 0, 0, 0, 0, 0, 0, 0, 0, 0, 0, 0, 0, 0, 0, 0, 0, 0, 0, 0, 0, 1665, 0, 0, 0, 0], 
[144, 144, 144, 144, 144, 168, 72, 1664, 0, 0, 0, 0, 0, 0, 0, 0, 0, 0, 0, 0, 0, 0, 0, 0, 0, 0, 0, 0, 0, 0, 0, 0, 0, 0, 0, 0, 0, 0, 0, 1665, 0, 0, 0, 0], 
[144, 144, 144, 144, 144, 168, 72, 1664, 0, 0, 0, 0, 0, 0, 0, 0, 0, 0, 0, 0, 0, 0, 0, 0, 0, 0, 0, 0, 0, 0, 0, 0, 0, 0, 0, 0, 0, 0, 0, 1665, 0, 0, 0, 0], 
[144, 144, 144, 144, 144, 168, 72, 1664, 0, 0, 0, 0, 0, 0, 0, 0, 0, 0, 0, 0, 0, 0, 0, 0, 0, 0, 0, 0, 0, 0, 0, 0, 0, 0, 0, 0, 0, 0, 0, 1665, 0, 0, 0, 0], 
[144, 144, 144, 144, 144, 168, 72, 1664, 0, 0, 0, 0, 0, 0, 0, 0, 0, 0, 0, 0, 0, 0, 0, 0, 0, 0, 0, 0, 0, 0, 0, 0, 0, 0, 0, 0, 0, 0, 0, 1665, 0, 0, 0, 0], 
[144, 144, 144, 144, 144, 168, 72, 1666, 1681, 1681, 1681, 1681, 1681, 1681, 1681, 1681, 1681, 1681, 1681, 1681, 1681, 1681, 1681, 1681, 1681, 1681, 1681, 1681, 1681, 1681, 1681, 1681, 1681, 1681, 1681, 1663, 0, 0, 0, 1665, 0, 0, 0, 0], 
[144, 144, 144, 144, 144, 168, 72, 1664, 0, 0, 0, 0, 0, 0, 0, 0, 0, 0, 0, 0, 0, 0, 0, 0, 3296, 3360, 3361, 3361, 3361, 3361, 3362, 859, 859, 859, 859, 1672, 0, 0, 0, 1704, 0, 0, 0, 0], 
[144, 144, 144, 144, 144, 168, 72, 1664, 0, 0, 0, 0, 0, 0, 0, 0, 0, 0, 0, 0, 0, 0, 0, 0, 3304, 3305, 3306, 3307, 3307, 3308, 3309, 3310, 0, 0, 0, 0, 0, 0, 0, 0, 0, 0, 0, 0], 
[144, 144, 144, 144, 144, 168, 72, 1664, 0, 0, 0, 0, 0, 0, 0, 0, 0, 0, 0, 0, 0, 0, 0, 0, 3312, 3344, 3345, 3345, 3345, 3345, 3346, 3318, 0, 0, 0, 0, 0, 0, 0, 0, 0, 0, 0, 0], 
[144, 144, 144, 144, 144, 168, 72, 1664, 0, 0, 0, 0, 0, 0, 0, 0, 0, 0, 0, 0, 0, 0, 0, 0, 3320, 3384, 3385, 3385, 3385, 3385, 3386, 3326, 0, 0, 0, 0, 0, 0, 0, 0, 0, 0, 0, 0], 
[144, 144, 144, 144, 144, 168, 72, 1664, 0, 0, 0, 0, 0, 0, 0, 0, 0, 0, 0, 0, 0, 1662, 1681, 1681, 1681, 1681, 1681, 1681, 1681, 1681, 1681, 1681, 1681, 1681, 1681, 1681, 1681, 1681, 1681, 1682, 0, 0, 0, 0], 
[144, 144, 144, 144, 144, 168, 72, 1664, 0, 0, 0, 0, 0, 0, 0, 0, 0, 0, 0, 0, 0, 1665, 0, 0, 0, 0, 0, 0, 0, 0, 0, 0, 0, 0, 0, 0, 0, 0, 0, 0, 0, 0, 0, 0], 
[144, 144, 144, 144, 144, 168, 72, 1664, 0, 0, 0, 0, 0, 0, 0, 0, 0, 0, 0, 0, 0, 1665, 0, 0, 0, 0, 0, 0, 0, 0, 0, 0, 0, 0, 0, 0, 0, 0, 0, 0, 0, 0, 0, 0], 
[144, 144, 144, 144, 144, 168, 72, 1664, 0, 0, 0, 0, 0, 0, 0, 0, 0, 0, 0, 0, 0, 1665, 0, 0, 0, 0, 0, 0, 0, 0, 0, 0, 0, 0, 0, 0, 0, 0, 0, 0, 0, 0, 0, 0], 
[144, 144, 144, 144, 144, 168, 72, 1664, 0, 0, 0, 0, 0, 0, 0, 0, 0, 0, 0, 0, 0, 1665, 0, 0, 0, 0, 0, 0, 0, 0, 0, 0, 0, 0, 0, 0, 0, 0, 0, 0, 0, 0, 0, 0], 
[144, 144, 144, 144, 144, 168, 72, 1664, 0, 0, 0, 0, 0, 0, 0, 0, 0, 0, 0, 0, 0, 1665, 0, 0, 0, 0, 0, 0, 0, 0, 0, 0, 0, 0, 0, 0, 0, 0, 0, 0, 0, 0, 0, 0], 
[144, 144, 144, 144, 144, 168, 72, 1664, 0, 0, 0, 0, 0, 0, 0, 0, 0, 0, 0, 0, 0, 1665, 0, 0, 0, 0, 0, 0, 0, 0, 0, 0, 0, 0, 0, 0, 0, 0, 0, 0, 0, 0, 0, 0]], 

[[0, 0, 0, 0, 0, 0, 0, 0, 0, 0, 0, 0, 0, 0, 0, 0, 0, 0, 0, 0, 0, 0, 0, 0, 0, 0, 0, 0, 0, 0, 0, 0, 0, 0, 0, 0, 0, 0, 0, 0, 0, 0, 0, 0], 
[0, 0, 0, 0, 0, 0, 0, 0, 0, 0, 0, 0, 0, 0, 0, 0, 0, 0, 0, 0, 0, 0, 0, 0, 0, 0, 0, 0, 0, 0, 0, 0, 0, 0, 0, 0, 0, 0, 0, 0, 0, 0, 0, 0], 
[0, 0, 0, 0, 0, 0, 0, 0, 0, 0, 0, 0, 0, 0, 0, 0, 0, 0, 0, 0, 0, 0, 0, 0, 0, 0, 0, 0, 0, 0, 0, 0, 0, 0, 0, 0, 0, 0, 0, 0, 0, 0, 0, 0], 
[0, 0, 0, 0, 0, 0, 0, 0, 0, 0, 0, 0, 0, 0, 0, 0, 0, 0, 0, 0, 0, 0, 0, 0, 0, 0, 0, 0, 0, 0, 0, 0, 0, 0, 0, 0, 0, 0, 0, 0, 0, 0, 0, 0], 
[0, 0, 0, 0, 0, 0, 1131, 0, 0, 0, 0, 0, 0, 0, 0, 0, 0, 0, 0, 0, 0, 0, 0, 0, 0, 0, 0, 0, 0, 0, 0, 0, 0, 0, 0, 0, 0, 0, 0, 0, 0, 0, 0, 0], 
[0, 0, 0, 0, 0, 0, 0, 0, 0, 0, 0, 0, 0, 0, 0, 0, 0, 0, 0, 0, 0, 0, 0, 0, 0, 0, 0, 0, 0, 0, 0, 0, 0, 0, 0, 0, 0, 0, 0, 0, 0, 0, 0, 0], 
[0, 0, 0, 0, 0, 0, 0, 0, 0, 0, 0, 0, 0, 0, 0, 0, 0, 0, 0, 0, 0, 0, 0, 0, 0, 0, 0, 0, 0, 0, 0, 0, 0, 0, 0, 0, 0, 0, 0, 0, 0, 0, 0, 0], 
[0, 0, 0, 0, 0, 0, 0, 0, 0, 0, 0, 0, 0, 0, 0, 0, 0, 0, 0, 0, 0, 0, 0, 0, 0, 0, 0, 0, 0, 0, 0, 0, 0, 0, 0, 0, 0, 0, 0, 0, 0, 0, 0, 0], 
[0, 0, 0, 0, 0, 0, 0, 0, 0, 0, 0, 0, 0, 0, 0, 0, 0, 0, 0, 0, 0, 0, 0, 0, 0, 0, 0, 0, 0, 0, 0, 0, 0, 0, 0, 0, 0, 0, 0, 0, 0, 0, 0, 0], 
[0, 0, 0, 0, 0, 0, 0, 0, 0, 0, 0, 0, 0, 0, 0, 0, 0, 0, 0, 0, 0, 0, 0, 0, 0, 0, 0, 0, 0, 0, 0, 0, 0, 0, 0, 0, 0, 0, 0, 0, 0, 0, 0, 0], 
[0, 0, 0, 0, 0, 0, 0, 0, 0, 0, 0, 0, 0, 0, 0, 0, 0, 0, 0, 0, 0, 0, 0, 0, 0, 0, 0, 0, 0, 0, 0, 0, 0, 0, 0, 0, 0, 0, 0, 0, 0, 0, 0, 0], 
[0, 0, 0, 0, 0, 0, 0, 0, 0, 0, 0, 0, 0, 0, 0, 0, 0, 0, 0, 0, 0, 0, 0, 0, 0, 3352, 3353, 3353, 3353, 3353, 3354, 0, 0, 0, 0, 0, 0, 0, 0, 0, 0, 0, 0, 0], 
[0, 0, 0, 0, 0, 0, 0, 0, 0, 0, 0, 0, 0, 0, 0, 0, 0, 0, 0, 0, 0, 0, 0, 0, 0, 0, 0, 0, 0, 0, 0, 3302, 0, 0, 0, 0, 0, 0, 0, 0, 0, 0, 0, 0], 
[0, 0, 0, 0, 0, 0, 0, 0, 0, 0, 0, 0, 0, 0, 0, 0, 0, 0, 0, 0, 0, 0, 0, 0, 0, 0, 0, 0, 0, 0, 0, 0, 0, 0, 0, 0, 0, 0, 0, 0, 0, 0, 0, 0], 
[0, 0, 0, 0, 0, 0, 0, 0, 0, 0, 0, 0, 0, 0, 0, 0, 0, 0, 0, 0, 0, 0, 0, 0, 0, 0, 0, 0, 0, 0, 0, 0, 0, 0, 0, 0, 0, 0, 0, 0, 0, 0, 0, 0], 
[0, 0, 0, 0, 0, 0, 0, 0, 0, 0, 0, 0, 0, 0, 0, 0, 0, 0, 0, 0, 0, 0, 0, 0, 0, 0, 0, 0, 0, 0, 0, 0, 0, 0, 0, 0, 0, 0, 0, 0, 0, 0, 0, 0], 
[0, 0, 0, 0, 0, 0, 0, 0, 0, 0, 0, 0, 0, 0, 0, 0, 0, 0, 0, 0, 0, 0, 804, 805, 804, 805, 804, 805, 804, 805, 804, 805, 804, 805, 804, 805, 804, 805, 804, 805, 804, 805, 804, 805], 
[0, 0, 0, 0, 0, 0, 0, 0, 0, 0, 0, 0, 0, 0, 0, 0, 0, 0, 0, 0, 0, 0, 0, 0, 0, 0, 0, 0, 0, 0, 0, 0, 0, 0, 0, 0, 0, 0, 0, 0, 0, 0, 0, 0], 
[0, 0, 0, 0, 0, 0, 0, 0, 0, 0, 0, 0, 0, 0, 0, 0, 0, 0, 0, 0, 0, 0, 0, 0, 0, 0, 0, 0, 0, 0, 0, 0, 0, 0, 0, 0, 0, 0, 0, 0, 0, 0, 0, 0], 
[0, 0, 0, 0, 0, 0, 0, 0, 0, 0, 0, 0, 0, 0, 0, 0, 0, 0, 0, 0, 0, 0, 0, 0, 0, 0, 0, 0, 0, 0, 0, 0, 0, 0, 0, 0, 0, 0, 0, 0, 0, 0, 0, 0], 
[0, 0, 0, 0, 0, 0, 0, 0, 0, 0, 0, 0, 0, 0, 0, 0, 0, 0, 0, 0, 0, 0, 0, 0, 0, 0, 0, 0, 0, 0, 0, 0, 0, 0, 0, 0, 0, 0, 0, 0, 0, 0, 0, 0], 
[0, 0, 0, 0, 0, 0, 0, 0, 0, 0, 0, 0, 0, 0, 0, 0, 0, 0, 0, 0, 0, 0, 0, 0, 0, 0, 0, 0, 0, 0, 0, 0, 0, 0, 0, 0, 0, 0, 0, 0, 0, 0, 0, 0], 
[0, 0, 0, 0, 0, 0, 0, 1408, 1409, 0, 0, 0, 0, 0, 0, 0, 0, 0, 0, 0, 1410, 1411, 0, 0, 0, 0, 0, 0, 0, 0, 0, 0, 0, 0, 0, 0, 0, 0, 0, 0, 0, 0, 0, 0]]]
}
}
