{
	"Map": {
		"id": 50,
		"map_display_x": 0,
		"map_display_y": 0,
		"width": 30,
		"height": 26,
		"xsize": 30,
		"ysize": 26,
		"zsize": 3,
		"Name" : "Rock Cave",
		"Parent" : "Rock Cave",
		"Tileset" : "Caves",
		"BattleBack" : "",
		"Autoplay_bgm" : true,
		"BGM" : "Cave",
		"Autoplay_bgs" : false,
		"BGS" : "",
		"Encounter_list" : [],
		"Encounter_step" : 30,
		"table": [[[529, 529, 529, 529, 529, 529, 529, 529, 529, 529, 529, 529, 529, 529, 529, 529, 529, 529, 529, 529, 529, 529, 529, 529, 529, 529, 529, 529, 529, 529], 
[529, 529, 529, 529, 529, 529, 529, 529, 529, 529, 529, 529, 529, 529, 529, 529, 529, 529, 529, 529, 529, 529, 529, 529, 529, 529, 529, 529, 529, 529], 
[529, 529, 529, 529, 529, 529, 529, 529, 529, 529, 529, 529, 529, 529, 529, 529, 529, 529, 529, 529, 529, 529, 529, 529, 529, 529, 529, 529, 529, 529], 
[529, 529, 529, 529, 529, 529, 529, 529, 529, 529, 529, 529, 529, 529, 529, 529, 529, 529, 529, 529, 529, 529, 529, 529, 529, 529, 513, 513, 513, 536], 
[529, 529, 529, 529, 529, 529, 529, 529, 529, 529, 529, 529, 529, 529, 529, 529, 529, 529, 529, 529, 529, 529, 529, 529, 529, 513, 513, 536, 513, 513], 
[611, 529, 529, 529, 529, 529, 529, 529, 529, 529, 529, 529, 529, 529, 529, 529, 529, 529, 529, 529, 529, 529, 529, 529, 513, 513, 513, 513, 513, 513], 
[611, 610, 610, 610, 610, 610, 611, 610, 610, 609, 610, 610, 610, 610, 610, 610, 611, 610, 610, 610, 610, 610, 610, 513, 513, 513, 536, 513, 513, 513], 
[619, 610, 610, 610, 610, 610, 611, 610, 610, 609, 610, 610, 610, 610, 610, 610, 611, 610, 610, 610, 610, 610, 610, 513, 513, 513, 513, 513, 513, 536], 
[610, 610, 610, 610, 610, 610, 611, 610, 610, 617, 618, 618, 610, 610, 618, 618, 619, 610, 610, 610, 610, 610, 610, 513, 513, 513, 513, 536, 513, 513], 
[610, 610, 610, 610, 610, 610, 611, 610, 610, 610, 610, 610, 610, 610, 610, 610, 610, 610, 610, 610, 610, 610, 610, 513, 513, 513, 513, 513, 513, 513], 
[610, 610, 610, 610, 610, 610, 611, 610, 610, 610, 610, 610, 610, 610, 610, 610, 610, 610, 610, 610, 610, 610, 610, 513, 513, 513, 536, 513, 513, 536], 
[610, 610, 610, 610, 610, 610, 611, 610, 610, 610, 610, 610, 610, 610, 610, 610, 610, 610, 610, 610, 610, 610, 610, 513, 513, 513, 513, 513, 513, 513], 
[610, 610, 610, 610, 610, 610, 611, 610, 610, 610, 610, 610, 610, 610, 610, 610, 610, 610, 610, 610, 610, 610, 610, 513, 513, 513, 513, 513, 513, 513], 
[611, 610, 610, 610, 610, 610, 611, 610, 610, 610, 610, 610, 610, 610, 610, 610, 610, 610, 610, 542, 543, 610, 610, 513, 513, 513, 513, 513, 513, 513], 
[611, 610, 610, 610, 610, 610, 611, 610, 610, 610, 610, 610, 610, 610, 610, 610, 610, 610, 610, 550, 551, 610, 610, 513, 513, 513, 513, 513, 513, 513], 
[611, 610, 610, 610, 610, 610, 611, 610, 610, 610, 610, 610, 610, 610, 610, 604, 618, 618, 618, 618, 618, 618, 618, 513, 513, 513, 513, 513, 513, 513], 
[611, 610, 610, 610, 610, 610, 611, 610, 610, 610, 610, 610, 610, 610, 610, 611, 494, 494, 494, 494, 494, 494, 494, 494, 494, 494, 494, 494, 494, 494], 
[611, 610, 610, 610, 610, 610, 610, 610, 610, 610, 610, 610, 610, 610, 610, 611, 494, 494, 494, 494, 494, 494, 494, 494, 494, 494, 494, 494, 494, 494], 
[619, 610, 610, 610, 610, 610, 610, 610, 610, 610, 610, 610, 610, 610, 610, 611, 494, 494, 494, 494, 494, 494, 494, 494, 494, 494, 494, 494, 494, 494], 
[618, 618, 618, 618, 618, 618, 618, 618, 618, 618, 618, 618, 618, 618, 618, 619, 494, 494, 494, 494, 494, 494, 494, 494, 494, 494, 494, 494, 494, 494], 
[494, 494, 494, 494, 494, 494, 494, 494, 494, 494, 494, 494, 494, 494, 494, 494, 494, 494, 494, 494, 494, 494, 494, 494, 494, 494, 494, 494, 494, 494], 
[494, 494, 494, 494, 494, 494, 494, 494, 494, 494, 494, 494, 494, 494, 494, 494, 494, 494, 494, 494, 494, 494, 494, 494, 494, 494, 494, 494, 494, 494], 
[494, 494, 494, 494, 494, 494, 494, 494, 494, 494, 494, 494, 494, 494, 494, 494, 494, 494, 494, 494, 494, 494, 494, 494, 494, 494, 494, 494, 494, 494], 
[494, 494, 494, 494, 494, 494, 494, 494, 494, 494, 494, 494, 494, 494, 494, 494, 494, 494, 494, 494, 494, 494, 494, 494, 494, 494, 494, 494, 494, 494], 
[494, 494, 494, 494, 494, 494, 494, 494, 494, 494, 494, 494, 494, 494, 494, 494, 494, 494, 494, 494, 494, 494, 494, 494, 494, 494, 494, 494, 494, 494], 
[494, 494, 494, 494, 494, 494, 494, 494, 494, 494, 494, 494, 494, 494, 494, 494, 494, 494, 494, 494, 494, 494, 494, 494, 494, 494, 494, 494, 494, 494]], 

[[529, 529, 529, 529, 529, 529, 529, 529, 529, 529, 529, 529, 529, 529, 529, 529, 529, 529, 529, 529, 529, 529, 529, 529, 529, 521, 521, 521, 521, 521], 
[529, 529, 529, 529, 529, 529, 529, 529, 529, 529, 529, 529, 529, 529, 529, 529, 529, 529, 529, 529, 529, 529, 529, 529, 521, 521, 521, 521, 521, 521], 
[529, 529, 529, 529, 529, 529, 529, 529, 529, 529, 529, 529, 529, 529, 529, 529, 529, 529, 529, 529, 529, 529, 529, 521, 521, 521, 521, 521, 521, 521], 
[529, 529, 529, 529, 529, 529, 529, 529, 529, 529, 529, 529, 529, 529, 529, 529, 529, 529, 529, 529, 529, 529, 521, 521, 521, 511, 0, 0, 0, 0], 
[529, 529, 529, 529, 529, 529, 529, 529, 529, 529, 529, 529, 529, 529, 529, 529, 529, 529, 529, 529, 529, 521, 521, 521, 511, 512, 0, 0, 0, 0], 
[0, 571, 529, 529, 529, 529, 529, 529, 529, 529, 529, 529, 529, 529, 529, 529, 529, 529, 529, 529, 521, 521, 521, 511, 512, 512, 0, 0, 0, 0], 
[0, 514, 0, 0, 559, 565, 0, 510, 511, 0, 0, 0, 0, 0, 0, 0, 0, 510, 521, 526, 527, 521, 511, 512, 512, 512, 0, 0, 0, 0], 
[0, 514, 0, 0, 567, 0, 0, 514, 512, 0, 0, 0, 0, 0, 447, 0, 0, 514, 0, 534, 535, 0, 512, 512, 512, 512, 0, 0, 0, 0], 
[521, 522, 0, 0, 0, 0, 0, 514, 512, 0, 0, 0, 0, 0, 0, 0, 0, 514, 0, 0, 0, 0, 512, 512, 512, 512, 0, 0, 0, 0], 
[0, 557, 0, 0, 0, 0, 0, 514, 520, 521, 521, 521, 539, 539, 521, 521, 521, 522, 0, 0, 0, 565, 512, 512, 512, 512, 0, 0, 0, 0], 
[0, 0, 0, 0, 0, 0, 0, 514, 0, 0, 0, 0, 0, 0, 0, 0, 0, 0, 0, 0, 0, 565, 512, 512, 512, 512, 0, 0, 0, 0], 
[0, 0, 0, 0, 0, 0, 0, 514, 0, 0, 565, 0, 0, 0, 0, 0, 0, 0, 0, 0, 0, 0, 512, 512, 512, 512, 0, 0, 0, 0], 
[603, 506, 0, 0, 0, 0, 0, 514, 0, 565, 0, 0, 0, 0, 0, 0, 0, 0, 0, 0, 0, 0, 512, 512, 512, 520, 521, 521, 521, 521], 
[0, 514, 0, 0, 0, 0, 0, 514, 0, 0, 0, 0, 0, 0, 0, 0, 0, 0, 0, 0, 0, 0, 512, 512, 520, 521, 521, 521, 521, 521], 
[0, 514, 0, 0, 0, 558, 0, 514, 0, 0, 0, 0, 0, 0, 0, 0, 0, 0, 0, 0, 0, 0, 512, 520, 521, 521, 521, 521, 521, 521], 
[0, 514, 0, 0, 0, 566, 0, 514, 0, 0, 0, 0, 0, 0, 0, 0, 0, 0, 0, 0, 0, 0, 520, 521, 521, 521, 521, 521, 521, 521], 
[0, 514, 0, 0, 0, 0, 0, 514, 0, 0, 0, 0, 0, 0, 0, 0, 510, 521, 521, 521, 521, 521, 521, 521, 521, 521, 521, 521, 521, 521], 
[0, 514, 0, 0, 0, 0, 0, 0, 0, 0, 0, 0, 0, 0, 0, 0, 514, 0, 0, 0, 0, 0, 0, 0, 0, 0, 0, 0, 0, 0], 
[0, 514, 0, 0, 0, 0, 0, 0, 0, 0, 0, 0, 0, 0, 557, 0, 514, 0, 0, 0, 0, 0, 0, 0, 0, 0, 0, 0, 0, 0], 
[521, 522, 0, 0, 0, 0, 0, 0, 0, 0, 0, 0, 0, 0, 0, 0, 514, 0, 0, 0, 0, 0, 0, 0, 0, 0, 0, 0, 0, 0], 
[521, 521, 521, 521, 521, 521, 521, 521, 521, 521, 521, 521, 521, 521, 521, 521, 522, 0, 0, 0, 0, 0, 0, 0, 0, 0, 0, 0, 0, 0], 
[0, 0, 0, 0, 0, 0, 0, 0, 0, 0, 0, 0, 0, 0, 0, 0, 0, 0, 0, 0, 0, 0, 0, 0, 0, 0, 0, 0, 0, 0], 
[0, 0, 0, 0, 0, 0, 0, 0, 0, 0, 0, 0, 0, 0, 0, 0, 0, 0, 0, 0, 0, 0, 0, 0, 0, 0, 0, 0, 0, 0], 
[0, 0, 0, 0, 0, 0, 0, 0, 0, 0, 0, 0, 0, 0, 0, 0, 0, 0, 0, 0, 0, 0, 0, 0, 0, 0, 0, 0, 0, 0], 
[0, 0, 0, 0, 0, 0, 0, 0, 0, 0, 0, 0, 0, 0, 0, 0, 0, 0, 0, 0, 0, 0, 0, 0, 0, 0, 0, 0, 0, 0], 
[0, 0, 0, 0, 0, 0, 0, 0, 0, 0, 0, 0, 0, 0, 0, 0, 0, 0, 0, 0, 0, 0, 0, 0, 0, 0, 0, 0, 0, 0]], 

[[0, 0, 0, 0, 0, 0, 0, 0, 0, 0, 0, 0, 0, 0, 0, 0, 0, 0, 0, 0, 0, 0, 0, 0, 0, 0, 0, 0, 0, 0], 
[0, 0, 0, 0, 0, 0, 0, 0, 0, 0, 0, 0, 0, 0, 0, 0, 0, 0, 0, 0, 0, 0, 0, 0, 0, 0, 0, 0, 0, 0], 
[0, 0, 552, 554, 0, 0, 0, 0, 0, 0, 0, 0, 0, 0, 0, 0, 0, 0, 0, 0, 0, 0, 0, 0, 0, 0, 0, 0, 0, 0], 
[0, 0, 560, 562, 0, 0, 0, 0, 0, 0, 0, 0, 0, 0, 0, 0, 0, 0, 0, 0, 0, 0, 0, 0, 0, 0, 0, 0, 0, 0], 
[0, 0, 560, 562, 0, 0, 0, 0, 0, 0, 0, 0, 0, 0, 0, 0, 0, 0, 0, 0, 0, 0, 0, 0, 0, 0, 0, 0, 0, 0], 
[0, 0, 560, 562, 0, 0, 0, 0, 0, 0, 0, 0, 0, 0, 0, 0, 0, 0, 0, 0, 0, 0, 0, 0, 0, 0, 0, 0, 0, 0], 
[0, 0, 560, 562, 0, 0, 0, 0, 0, 0, 0, 0, 0, 0, 0, 0, 0, 0, 0, 0, 0, 0, 0, 0, 0, 0, 0, 0, 0, 0], 
[0, 0, 560, 562, 0, 0, 0, 0, 0, 0, 0, 0, 0, 0, 0, 0, 0, 0, 0, 0, 0, 0, 0, 0, 0, 0, 0, 0, 0, 0], 
[0, 0, 560, 562, 0, 0, 0, 0, 0, 0, 0, 0, 0, 0, 0, 0, 0, 0, 0, 0, 0, 0, 0, 0, 0, 0, 0, 0, 0, 0], 
[0, 0, 560, 562, 0, 0, 0, 0, 0, 0, 0, 0, 0, 0, 0, 0, 0, 0, 0, 0, 0, 0, 0, 0, 0, 0, 0, 0, 0, 0], 
[0, 0, 560, 562, 0, 0, 0, 0, 0, 0, 0, 0, 0, 0, 0, 0, 0, 0, 0, 0, 0, 0, 0, 0, 0, 0, 0, 0, 0, 0], 
[0, 0, 560, 562, 0, 0, 0, 0, 0, 0, 540, 0, 0, 0, 0, 0, 0, 0, 0, 0, 0, 0, 0, 0, 0, 0, 0, 0, 0, 0], 
[0, 0, 560, 562, 0, 0, 0, 0, 0, 0, 548, 0, 0, 0, 0, 0, 0, 0, 0, 0, 0, 0, 0, 0, 0, 0, 0, 0, 0, 0], 
[0, 0, 560, 562, 0, 0, 0, 0, 0, 0, 0, 0, 0, 0, 0, 0, 0, 0, 0, 0, 0, 0, 0, 0, 0, 0, 0, 0, 0, 0], 
[0, 0, 560, 562, 0, 0, 0, 0, 0, 0, 0, 0, 0, 0, 0, 0, 0, 0, 0, 0, 0, 0, 0, 0, 0, 0, 0, 0, 0, 0], 
[0, 0, 560, 562, 0, 0, 0, 0, 0, 0, 0, 0, 0, 0, 0, 0, 0, 0, 0, 0, 0, 0, 0, 0, 0, 0, 0, 0, 0, 0], 
[0, 0, 560, 563, 553, 553, 553, 553, 553, 553, 553, 553, 554, 0, 0, 0, 0, 0, 0, 0, 0, 0, 0, 0, 0, 0, 0, 0, 0, 0], 
[0, 0, 568, 569, 569, 569, 569, 569, 569, 569, 569, 569, 570, 0, 0, 0, 0, 0, 0, 0, 0, 0, 0, 0, 0, 0, 0, 0, 0, 0], 
[0, 0, 576, 577, 577, 577, 577, 577, 577, 577, 577, 577, 578, 0, 0, 0, 0, 0, 0, 0, 0, 0, 0, 0, 0, 0, 0, 0, 0, 0], 
[0, 0, 576, 577, 577, 577, 577, 577, 577, 577, 577, 577, 578, 0, 0, 0, 0, 0, 0, 0, 0, 0, 0, 0, 0, 0, 0, 0, 0, 0], 
[0, 0, 0, 0, 0, 0, 0, 0, 0, 0, 0, 0, 0, 0, 0, 0, 0, 0, 0, 0, 0, 0, 0, 0, 0, 0, 0, 0, 0, 0], 
[0, 0, 0, 0, 0, 0, 0, 0, 0, 0, 0, 0, 0, 0, 0, 0, 0, 0, 0, 0, 0, 0, 0, 0, 0, 0, 0, 0, 0, 0], 
[0, 0, 0, 0, 0, 0, 0, 0, 0, 0, 0, 0, 0, 0, 0, 0, 0, 0, 0, 0, 0, 0, 0, 0, 0, 0, 0, 0, 0, 0], 
[0, 0, 0, 0, 0, 0, 0, 0, 0, 0, 0, 0, 0, 0, 0, 0, 0, 0, 0, 0, 0, 0, 0, 0, 0, 0, 0, 0, 0, 0], 
[0, 0, 0, 0, 0, 0, 0, 0, 0, 0, 0, 0, 0, 0, 0, 0, 0, 0, 0, 0, 0, 0, 0, 0, 0, 0, 0, 0, 0, 0], 
[0, 0, 0, 0, 0, 0, 0, 0, 0, 0, 0, 0, 0, 0, 0, 0, 0, 0, 0, 0, 0, 0, 0, 0, 0, 0, 0, 0, 0, 0]]]
}
}
