{
	"Map": {
		"id": 52,
		"map_display_x": 0,
		"map_display_y": 0,
		"width": 44,
		"height": 36,
		"xsize": 44,
		"ysize": 36,
		"zsize": 3,
		"Name" : "Battle Frontier",
		"Parent" : "",
		"Tileset" : "Outside",
		"BattleBack" : "",
		"Autoplay_bgm" : true,
		"BGM" : "PkmRS-BTower",
		"Autoplay_bgs" : false,
		"BGS" : "",
		"Encounter_list" : [],
		"Encounter_step" : 30,
		"table": [[[1177, 1177, 1177, 1177, 1192, 1188, 1188, 1188, 1188, 1188, 1188, 1193, 1177, 1177, 1177, 1177, 1177, 1179, 1177, 1177, 1177, 1177, 1177, 1177, 1177, 1192, 1188, 1188, 1188, 1188, 1188, 1188, 1188, 1188, 1193, 1177, 1177, 1187, 1188, 1193, 1177, 1177, 1187, 1193], 
[1177, 1192, 1188, 1188, 1189, 1177, 1177, 1177, 1177, 1177, 1177, 1187, 1188, 1188, 1188, 1193, 1177, 1187, 1188, 1193, 1177, 1192, 1188, 1188, 1188, 1189, 1177, 1177, 1177, 1177, 1177, 1177, 1177, 1177, 1187, 1188, 1188, 1193, 1177, 1187, 1193, 1177, 1177, 1187], 
[1188, 1189, 1177, 1177, 1177, 1177, 1177, 1177, 1177, 1177, 1177, 1177, 1177, 1177, 1177, 1179, 1177, 1177, 1177, 1179, 1177, 1181, 1177, 1177, 1177, 1177, 1177, 1177, 1177, 1177, 1177, 1177, 1177, 1177, 1177, 1177, 1177, 1179, 1177, 1177, 1179, 1177, 1177, 1177], 
[1177, 1177, 1177, 1192, 389, 385, 386, 388, 389, 386, 387, 385, 389, 1193, 1177, 1187, 1188, 1193, 1177, 1187, 1193, 1181, 1177, 1177, 1192, 1188, 1188, 1188, 1188, 1188, 1188, 1188, 1188, 1188, 1193, 1177, 1177, 1179, 1177, 1177, 1179, 1177, 1177, 1177], 
[1177, 1177, 1177, 385, 388, 386, 385, 387, 385, 388, 387, 387, 385, 388, 1177, 1177, 1177, 1179, 1177, 1177, 1187, 1189, 1177, 1192, 1189, 1177, 1177, 1177, 1177, 1177, 1177, 1177, 1177, 1177, 1187, 1193, 1177, 1179, 1177, 1177, 1179, 1177, 1177, 1177], 
[1177, 1192, 386, 389, 386, 389, 387, 386, 388, 386, 389, 386, 387, 386, 388, 1193, 1177, 1179, 1177, 1177, 1177, 1177, 1177, 1181, 1177, 1177, 1177, 1177, 1177, 1177, 1177, 1177, 1177, 1177, 1177, 1179, 1177, 1179, 1177, 1177, 1187, 1188, 1193, 1177], 
[1177, 387, 274, 276, 385, 388, 385, 387, 386, 385, 385, 388, 389, 274, 276, 385, 1177, 1187, 1193, 1177, 1177, 1177, 1177, 1181, 1177, 1177, 1177, 1177, 1177, 1177, 1177, 1177, 1177, 1177, 1177, 1179, 1177, 1187, 1188, 1193, 1177, 1177, 1179, 1177], 
[1177, 385, 258, 278, 386, 385, 389, 388, 385, 387, 387, 386, 387, 280, 265, 386, 1177, 1177, 1187, 1188, 1188, 1188, 1188, 1189, 1177, 1177, 1177, 1177, 1177, 1177, 1177, 1177, 1177, 1177, 1177, 1179, 1177, 1177, 1177, 1179, 1177, 1177, 1179, 1177], 
[1177, 386, 272, 388, 387, 388, 386, 387, 386, 385, 385, 389, 385, 388, 272, 385, 1177, 1177, 1177, 1177, 1177, 1177, 1177, 1177, 1177, 1177, 1177, 1177, 1177, 1177, 1177, 1177, 1177, 1177, 1177, 1187, 1193, 1177, 1177, 1179, 1177, 1177, 1187, 1193], 
[1177, 389, 284, 389, 386, 385, 386, 784, 785, 786, 389, 385, 386, 389, 284, 388, 386, 385, 385, 386, 1193, 1177, 1177, 1177, 1192, 388, 385, 387, 784, 785, 786, 385, 389, 386, 1193, 1177, 1187, 1193, 1177, 1179, 1177, 1177, 1177, 1179], 
[1177, 385, 388, 386, 387, 386, 776, 779, 785, 780, 778, 387, 388, 385, 386, 387, 388, 385, 387, 388, 388, 385, 385, 388, 387, 386, 385, 776, 779, 785, 780, 778, 385, 286, 388, 1193, 1177, 1179, 1177, 1179, 1177, 1177, 1177, 1179], 
[1177, 388, 385, 389, 387, 387, 784, 785, 785, 785, 786, 389, 386, 387, 385, 385, 386, 386, 389, 385, 386, 387, 385, 386, 286, 389, 388, 784, 785, 785, 785, 786, 387, 386, 387, 385, 1177, 1179, 1177, 1187, 1193, 1177, 1177, 1179], 
[1177, 386, 387, 385, 389, 388, 784, 785, 785, 785, 786, 388, 385, 389, 286, 385, 389, 385, 387, 388, 385, 386, 389, 387, 387, 385, 386, 784, 785, 785, 785, 786, 385, 387, 286, 389, 1177, 1179, 1177, 1177, 1179, 1177, 1177, 1179], 
[423, 385, 283, 285, 386, 385, 784, 785, 785, 785, 786, 385, 387, 388, 386, 388, 388, 385, 386, 385, 387, 388, 385, 386, 388, 385, 387, 784, 785, 785, 785, 786, 389, 387, 388, 386, 1177, 1187, 1193, 1177, 1179, 1177, 1177, 1187], 
[776, 777, 777, 777, 777, 777, 779, 785, 785, 785, 780, 777, 777, 777, 777, 777, 777, 777, 777, 777, 777, 777, 777, 777, 777, 777, 777, 779, 785, 785, 785, 786, 387, 385, 387, 385, 1177, 1177, 1179, 1177, 1179, 1177, 1177, 1177], 
[784, 785, 785, 785, 785, 785, 785, 785, 785, 785, 785, 785, 785, 785, 785, 785, 785, 785, 785, 785, 785, 785, 785, 785, 785, 785, 785, 785, 785, 785, 785, 786, 386, 388, 282, 387, 1177, 1177, 1179, 1177, 1179, 1177, 1177, 1177], 
[784, 785, 785, 785, 785, 785, 785, 785, 785, 785, 785, 785, 785, 785, 785, 785, 785, 785, 785, 785, 785, 785, 785, 785, 785, 785, 785, 785, 785, 785, 785, 786, 387, 283, 279, 389, 1177, 1177, 1179, 1177, 1179, 1177, 1177, 1177], 
[792, 793, 793, 793, 793, 793, 793, 793, 793, 793, 793, 793, 793, 793, 793, 793, 787, 785, 785, 785, 788, 793, 793, 793, 793, 793, 793, 793, 793, 793, 793, 794, 385, 388, 387, 386, 1193, 1177, 1179, 1177, 1187, 1193, 1177, 1177], 
[388, 385, 389, 387, 386, 388, 389, 385, 387, 386, 385, 388, 386, 388, 385, 387, 784, 785, 785, 785, 786, 385, 387, 386, 387, 389, 386, 385, 387, 387, 387, 386, 385, 386, 389, 282, 388, 1177, 1187, 1193, 1177, 1179, 1177, 1177], 
[1177, 387, 286, 386, 387, 388, 386, 388, 388, 386, 388, 387, 388, 385, 282, 386, 784, 785, 785, 785, 786, 389, 275, 285, 387, 386, 385, 387, 385, 386, 389, 387, 387, 388, 387, 284, 387, 1177, 1177, 1179, 1177, 1179, 1177, 1177], 
[1173, 385, 388, 389, 385, 387, 385, 386, 387, 388, 387, 385, 387, 387, 284, 389, 784, 785, 785, 785, 786, 386, 284, 388, 387, 386, 388, 387, 388, 387, 385, 386, 389, 386, 385, 389, 385, 1177, 1177, 1179, 1177, 1187, 1193, 1177], 
[1181, 389, 386, 387, 282, 389, 389, 387, 386, 385, 389, 387, 388, 386, 388, 385, 784, 785, 785, 785, 786, 385, 385, 385, 388, 385, 387, 385, 389, 386, 387, 385, 387, 386, 385, 388, 386, 1177, 1177, 1179, 1177, 1177, 1179, 1177], 
[1181, 387, 388, 388, 284, 387, 385, 389, 387, 388, 387, 386, 387, 386, 286, 387, 784, 785, 785, 785, 786, 388, 387, 389, 386, 387, 386, 387, 387, 388, 387, 386, 387, 388, 387, 286, 387, 1177, 1177, 1179, 1177, 1171, 1201, 1177], 
[1181, 387, 385, 386, 387, 388, 387, 389, 784, 785, 786, 389, 385, 388, 385, 388, 784, 785, 785, 785, 786, 385, 386, 388, 387, 385, 389, 386, 388, 386, 385, 387, 389, 385, 387, 388, 1201, 1177, 1177, 1179, 1177, 1179, 1177, 1177], 
[1181, 1200, 386, 387, 388, 385, 389, 388, 784, 785, 786, 387, 386, 388, 388, 386, 784, 785, 785, 785, 786, 386, 387, 385, 386, 388, 387, 784, 785, 786, 387, 385, 386, 388, 386, 387, 1177, 1177, 1171, 1201, 1177, 1179, 1177, 1177], 
[1181, 1177, 388, 388, 385, 387, 387, 776, 779, 785, 780, 777, 777, 777, 777, 777, 779, 785, 785, 785, 780, 777, 777, 777, 777, 777, 777, 779, 785, 780, 778, 388, 387, 386, 385, 385, 1177, 1177, 1179, 1177, 1177, 1179, 1177, 1177], 
[1181, 1177, 385, 387, 388, 386, 389, 784, 785, 785, 785, 785, 785, 785, 785, 785, 785, 785, 785, 785, 785, 785, 785, 785, 785, 785, 785, 785, 785, 785, 786, 386, 385, 387, 286, 389, 1177, 1171, 1201, 1177, 1171, 1201, 1177, 1177], 
[1181, 1177, 1200, 388, 286, 387, 385, 784, 785, 785, 785, 785, 785, 785, 785, 785, 785, 785, 785, 785, 785, 785, 785, 785, 785, 785, 785, 785, 785, 785, 786, 389, 386, 388, 387, 1201, 1177, 1179, 1177, 1177, 1179, 1177, 1177, 1171], 
[1200, 1173, 1177, 1200, 385, 286, 386, 792, 793, 793, 793, 793, 793, 793, 793, 793, 793, 793, 793, 793, 793, 793, 793, 793, 793, 793, 793, 793, 793, 793, 794, 388, 387, 385, 1177, 1177, 1171, 1201, 1177, 1171, 1201, 1177, 1177, 1179], 
[1177, 1200, 1173, 1177, 1200, 389, 385, 387, 388, 385, 386, 387, 385, 386, 388, 283, 273, 285, 389, 283, 273, 285, 389, 386, 387, 385, 388, 386, 385, 387, 386, 385, 389, 1201, 1177, 1171, 1201, 1177, 1171, 1201, 1177, 1177, 1171, 1201], 
[1177, 1177, 1181, 1177, 1177, 1177, 1177, 1177, 1177, 1177, 1177, 1177, 1177, 1177, 1200, 389, 386, 385, 387, 386, 388, 385, 1201, 1177, 1177, 1177, 1177, 1177, 1177, 1177, 1177, 1177, 1171, 1172, 1172, 1201, 1177, 1177, 1179, 1177, 1177, 1171, 1201, 1177], 
[1173, 1177, 1200, 1172, 1172, 1172, 1172, 1172, 1173, 1177, 1177, 1171, 1172, 1173, 1177, 1177, 1177, 1177, 1177, 1177, 1177, 1177, 1177, 1177, 1171, 1172, 1172, 1172, 1172, 1172, 1172, 1172, 1201, 1177, 1177, 1177, 1177, 1171, 1201, 1177, 1171, 1201, 1177, 1177], 
[1200, 1172, 1172, 1172, 1172, 1172, 1173, 1177, 1200, 1172, 1172, 1201, 1177, 1200, 1172, 1173, 1177, 1177, 1177, 1177, 1177, 1171, 1172, 1172, 1201, 1177, 1177, 1177, 1177, 1177, 1177, 1177, 1177, 1177, 1177, 1177, 1177, 1179, 1177, 1177, 1179, 1177, 1177, 1177], 
[1177, 1171, 1172, 1172, 1173, 1177, 1200, 1172, 1172, 1172, 1172, 1172, 1172, 1173, 1177, 1200, 1172, 1172, 1172, 1172, 1172, 1201, 1177, 1177, 1177, 1177, 1177, 1177, 1177, 1177, 1177, 1177, 1171, 1172, 1172, 1172, 1172, 1201, 1177, 1171, 1201, 1177, 1177, 1177], 
[1177, 1179, 1177, 1177, 1200, 1172, 1172, 1173, 1177, 1177, 1177, 1177, 1177, 1181, 1177, 1177, 1177, 1177, 1177, 1177, 1177, 1177, 1177, 1171, 1172, 1172, 1172, 1172, 1173, 1177, 1177, 1177, 1179, 1177, 1177, 1177, 1177, 1177, 1177, 1179, 1177, 1177, 1177, 1177], 
[1171, 1201, 1177, 1177, 1177, 1177, 1177, 1200, 1172, 1172, 1173, 1177, 1177, 1200, 1172, 1172, 1172, 1172, 1173, 1177, 1171, 1172, 1172, 1201, 1177, 1177, 1177, 1177, 1200, 1172, 1172, 1172, 1201, 1177, 1177, 1177, 1171, 1172, 1172, 1201, 1177, 1177, 1177, 1177]], 

[[0, 0, 0, 0, 0, 0, 0, 0, 0, 0, 0, 0, 0, 0, 0, 0, 0, 0, 0, 0, 0, 0, 0, 0, 0, 0, 3771, 3780, 3781, 3782, 3783, 3808, 3793, 0, 0, 0, 0, 0, 0, 0, 0, 0, 0, 0], 
[0, 0, 0, 0, 0, 0, 0, 0, 0, 0, 0, 0, 0, 0, 0, 0, 0, 0, 0, 0, 0, 0, 0, 0, 0, 0, 3771, 3764, 3765, 3766, 3767, 3792, 3793, 0, 0, 0, 0, 0, 0, 0, 0, 0, 0, 0], 
[0, 0, 0, 0, 2832, 2833, 2833, 2834, 2835, 2836, 2837, 2837, 2838, 0, 0, 0, 0, 0, 0, 0, 0, 0, 0, 0, 0, 0, 3771, 3772, 3773, 3774, 3775, 3800, 3801, 0, 0, 0, 0, 0, 0, 0, 0, 0, 0, 0], 
[0, 0, 0, 0, 2840, 2841, 2841, 2842, 2843, 2844, 2845, 2845, 2846, 0, 0, 0, 0, 0, 0, 0, 0, 0, 0, 0, 0, 0, 3771, 3780, 3781, 3782, 3783, 3808, 3793, 0, 0, 0, 0, 0, 0, 0, 0, 0, 0, 0], 
[0, 0, 0, 1178, 2848, 2849, 2849, 2850, 2851, 2852, 2853, 2853, 2854, 1176, 0, 0, 0, 0, 0, 0, 0, 0, 0, 0, 0, 0, 3771, 3764, 3765, 3766, 3767, 3792, 3793, 0, 0, 0, 0, 0, 0, 0, 0, 0, 0, 0], 
[0, 0, 1185, 1186, 2856, 2857, 2857, 2858, 2859, 2860, 2861, 2861, 2862, 1184, 1185, 0, 0, 0, 0, 0, 0, 0, 0, 0, 0, 3770, 3771, 3772, 3773, 3774, 3775, 3800, 3801, 3802, 0, 0, 0, 0, 0, 0, 0, 0, 0, 0], 
[0, 1178, 0, 0, 2864, 2865, 2865, 2866, 2867, 2868, 2869, 2869, 2870, 0, 0, 1176, 0, 0, 0, 0, 0, 0, 0, 0, 0, 3778, 3779, 3780, 3781, 3782, 3783, 3808, 3809, 3810, 0, 0, 0, 0, 0, 0, 0, 0, 0, 0], 
[0, 1178, 0, 0, 2872, 2873, 2873, 2874, 2875, 2876, 2877, 2877, 2878, 0, 0, 1176, 0, 0, 0, 0, 0, 0, 0, 0, 0, 3786, 3787, 3788, 3789, 3790, 3791, 3816, 3817, 3818, 0, 0, 0, 0, 0, 0, 0, 0, 0, 0], 
[0, 1178, 0, 0, 859, 859, 859, 2882, 2883, 2884, 859, 859, 859, 0, 0, 1176, 0, 0, 0, 0, 0, 0, 0, 0, 0, 3794, 3795, 3796, 3797, 3798, 3799, 3824, 3825, 3826, 0, 0, 0, 0, 0, 0, 0, 0, 0, 0], 
[0, 1178, 0, 0, 0, 0, 0, 2890, 2891, 2892, 0, 0, 0, 0, 0, 1184, 1185, 1185, 1185, 1185, 0, 0, 0, 0, 0, 1185, 1185, 1185, 1185, 0, 1185, 1185, 1185, 1185, 0, 0, 0, 0, 0, 0, 0, 0, 0, 0], 
[0, 1178, 0, 0, 0, 0, 0, 0, 0, 0, 0, 0, 0, 0, 0, 0, 0, 0, 0, 0, 1184, 1185, 1185, 1185, 1186, 0, 0, 0, 0, 0, 0, 0, 0, 0, 1184, 0, 0, 0, 0, 0, 0, 0, 0, 0], 
[0, 1178, 0, 0, 0, 0, 0, 0, 0, 0, 0, 0, 0, 0, 0, 0, 0, 0, 0, 0, 0, 0, 0, 0, 0, 0, 0, 0, 0, 0, 0, 0, 0, 0, 0, 1176, 0, 0, 0, 0, 0, 0, 0, 0], 
[0, 1178, 0, 0, 0, 0, 0, 0, 0, 0, 0, 0, 0, 0, 0, 0, 0, 0, 0, 0, 0, 0, 0, 0, 0, 0, 0, 0, 0, 0, 0, 0, 0, 0, 0, 1176, 0, 0, 0, 0, 0, 0, 0, 0], 
[1185, 1186, 0, 0, 0, 0, 0, 0, 0, 0, 0, 0, 0, 0, 0, 0, 0, 0, 0, 0, 0, 0, 0, 0, 0, 0, 0, 0, 0, 0, 0, 0, 0, 0, 0, 1176, 0, 0, 0, 0, 0, 0, 0, 0], 
[0, 0, 0, 0, 0, 0, 0, 0, 0, 0, 0, 0, 0, 0, 0, 0, 0, 0, 0, 0, 0, 0, 0, 0, 0, 0, 0, 0, 0, 0, 0, 0, 0, 0, 0, 1176, 0, 0, 0, 0, 0, 0, 0, 0], 
[0, 0, 0, 0, 0, 0, 0, 0, 0, 0, 0, 0, 0, 0, 0, 0, 0, 0, 0, 0, 0, 0, 0, 0, 0, 0, 0, 0, 0, 0, 0, 0, 0, 0, 0, 1176, 0, 0, 0, 0, 0, 0, 0, 0], 
[0, 0, 0, 0, 0, 0, 0, 0, 0, 0, 0, 0, 0, 0, 0, 0, 0, 0, 0, 0, 0, 0, 0, 0, 0, 0, 0, 0, 0, 0, 0, 0, 0, 0, 0, 1176, 0, 0, 0, 0, 0, 0, 0, 0], 
[0, 0, 0, 0, 0, 0, 0, 0, 0, 0, 0, 0, 0, 0, 0, 0, 0, 0, 0, 0, 0, 0, 0, 0, 0, 4152, 0, 4154, 0, 4156, 0, 4158, 0, 0, 0, 1184, 0, 0, 0, 0, 0, 0, 0, 0], 
[1169, 1170, 0, 0, 0, 0, 0, 0, 0, 0, 0, 0, 0, 0, 0, 0, 0, 0, 0, 0, 0, 0, 0, 0, 4111, 4160, 4161, 4162, 4163, 4164, 4165, 4166, 4167, 0, 0, 0, 1176, 0, 0, 0, 0, 0, 0, 0], 
[0, 1178, 0, 0, 0, 1701, 1717, 1717, 1717, 1717, 1717, 1717, 1717, 1702, 0, 0, 0, 0, 0, 0, 0, 0, 0, 4218, 4119, 4168, 4169, 4170, 4171, 4172, 4173, 4174, 4175, 4219, 0, 0, 1176, 0, 0, 0, 0, 0, 0, 0], 
[0, 1178, 0, 0, 0, 1708, 3248, 3249, 3250, 3251, 3252, 3249, 3253, 1707, 0, 0, 0, 0, 0, 0, 0, 0, 0, 4234, 4127, 4176, 4177, 4178, 4179, 4180, 4181, 4182, 4183, 4235, 0, 0, 1176, 0, 0, 0, 0, 0, 0, 0], 
[0, 1178, 0, 0, 0, 1708, 3256, 3257, 3258, 3259, 3260, 3257, 3261, 1707, 0, 0, 0, 0, 0, 0, 0, 0, 0, 4226, 4135, 4184, 4185, 4186, 4187, 4188, 4189, 4190, 4191, 4227, 0, 0, 1176, 0, 0, 0, 0, 0, 0, 0], 
[0, 1178, 0, 0, 0, 1708, 3264, 3265, 3266, 3267, 3271, 3255, 3269, 1707, 0, 0, 0, 0, 0, 0, 0, 0, 0, 4234, 4143, 4192, 4193, 4194, 4195, 4196, 4197, 4198, 4199, 4235, 0, 0, 1176, 0, 0, 0, 0, 0, 0, 0], 
[0, 1178, 0, 0, 0, 1708, 3272, 3273, 3274, 3275, 3279, 3263, 3277, 1707, 0, 0, 0, 0, 0, 0, 0, 0, 0, 4242, 4151, 4200, 4201, 4202, 4203, 4204, 4205, 4206, 4207, 4243, 0, 1168, 0, 0, 0, 0, 0, 0, 0, 0], 
[0, 0, 1170, 0, 0, 1709, 1717, 1717, 0, 0, 0, 1717, 1717, 1710, 0, 0, 0, 0, 0, 0, 0, 0, 0, 0, 0, 0, 4209, 4210, 4211, 4212, 4213, 0, 0, 0, 0, 1176, 0, 0, 0, 0, 0, 0, 0, 0], 
[0, 0, 1178, 0, 0, 0, 0, 0, 0, 0, 0, 0, 0, 0, 0, 0, 0, 0, 0, 0, 0, 0, 0, 0, 0, 0, 0, 0, 0, 0, 0, 0, 0, 0, 0, 1176, 0, 0, 0, 0, 0, 0, 0, 0], 
[0, 0, 1178, 0, 0, 0, 0, 0, 0, 0, 0, 0, 0, 0, 0, 0, 0, 0, 0, 0, 0, 0, 0, 0, 0, 0, 0, 0, 0, 0, 0, 0, 0, 0, 0, 1176, 0, 0, 0, 0, 0, 0, 0, 0], 
[0, 0, 0, 1170, 0, 0, 0, 0, 0, 0, 0, 0, 0, 0, 0, 0, 0, 0, 0, 0, 0, 0, 0, 0, 0, 0, 0, 0, 0, 0, 0, 0, 0, 1168, 1169, 0, 0, 0, 0, 0, 0, 0, 0, 0], 
[0, 0, 0, 0, 1170, 0, 0, 0, 0, 0, 0, 0, 0, 0, 0, 0, 0, 0, 0, 0, 0, 0, 0, 0, 0, 0, 0, 0, 0, 0, 0, 0, 0, 1176, 0, 0, 0, 0, 0, 0, 0, 0, 0, 0], 
[0, 0, 0, 0, 0, 1169, 1169, 1169, 1169, 1169, 1169, 1169, 1169, 1169, 1170, 0, 0, 0, 0, 0, 0, 0, 1168, 1169, 1169, 1169, 1169, 1169, 1169, 1169, 1169, 1169, 1169, 0, 0, 0, 0, 0, 0, 0, 0, 0, 0, 0], 
[0, 0, 0, 0, 0, 0, 0, 0, 0, 0, 0, 0, 0, 0, 0, 1169, 1169, 1169, 1169, 1169, 1169, 1169, 0, 0, 0, 0, 0, 0, 0, 0, 0, 0, 0, 0, 0, 0, 0, 0, 0, 0, 0, 0, 0, 0], 
[0, 0, 0, 0, 0, 0, 0, 0, 0, 0, 0, 0, 0, 0, 0, 0, 0, 0, 0, 0, 0, 0, 0, 0, 0, 0, 0, 0, 0, 0, 0, 0, 0, 0, 0, 0, 0, 0, 0, 0, 0, 0, 0, 0], 
[0, 0, 0, 0, 0, 0, 0, 0, 0, 0, 0, 0, 0, 0, 0, 0, 0, 0, 0, 0, 0, 0, 0, 0, 0, 0, 0, 0, 0, 0, 0, 0, 0, 0, 0, 0, 0, 0, 0, 0, 0, 0, 0, 0], 
[0, 0, 0, 0, 0, 0, 0, 0, 0, 0, 0, 0, 0, 0, 0, 0, 0, 0, 0, 0, 0, 0, 0, 0, 0, 0, 0, 0, 0, 0, 0, 0, 0, 0, 0, 0, 0, 0, 0, 0, 0, 0, 0, 0], 
[0, 0, 0, 0, 0, 0, 0, 0, 0, 0, 0, 0, 0, 0, 0, 0, 0, 0, 0, 0, 0, 0, 0, 0, 0, 0, 0, 0, 0, 0, 0, 0, 0, 0, 0, 0, 0, 0, 0, 0, 0, 0, 0, 0], 
[0, 0, 0, 0, 0, 0, 0, 0, 0, 0, 0, 0, 0, 0, 0, 0, 0, 0, 0, 0, 0, 0, 0, 0, 0, 0, 0, 0, 0, 0, 0, 0, 0, 0, 0, 0, 0, 0, 0, 0, 0, 0, 0, 0]], 

[[0, 0, 0, 0, 0, 0, 0, 0, 0, 0, 0, 0, 0, 0, 0, 0, 0, 0, 0, 0, 0, 0, 0, 0, 0, 0, 0, 0, 0, 0, 0, 0, 0, 0, 0, 0, 0, 0, 0, 0, 0, 0, 0, 0], 
[0, 0, 0, 0, 0, 0, 0, 0, 0, 0, 0, 0, 0, 0, 0, 0, 0, 0, 0, 0, 0, 0, 0, 0, 0, 0, 0, 0, 0, 0, 0, 0, 0, 0, 0, 0, 0, 0, 0, 0, 0, 0, 0, 0], 
[0, 0, 0, 0, 0, 0, 0, 0, 0, 0, 0, 0, 0, 0, 0, 0, 0, 0, 0, 0, 0, 0, 0, 0, 0, 0, 0, 0, 0, 0, 0, 0, 0, 0, 0, 0, 0, 0, 0, 0, 0, 0, 0, 0], 
[0, 0, 0, 0, 0, 0, 0, 0, 0, 0, 0, 0, 0, 0, 0, 0, 0, 0, 0, 0, 0, 0, 0, 0, 0, 0, 0, 0, 0, 0, 0, 0, 0, 0, 0, 0, 0, 0, 0, 0, 0, 0, 0, 0], 
[0, 0, 0, 0, 0, 0, 0, 0, 0, 0, 0, 0, 0, 0, 0, 0, 0, 0, 0, 0, 0, 0, 0, 0, 0, 0, 0, 0, 0, 0, 0, 0, 0, 0, 0, 0, 0, 0, 0, 0, 0, 0, 0, 0], 
[0, 0, 0, 0, 0, 0, 0, 0, 0, 0, 0, 0, 0, 0, 0, 0, 0, 0, 0, 0, 0, 0, 0, 0, 0, 0, 0, 0, 0, 0, 0, 0, 0, 0, 0, 0, 0, 0, 0, 0, 0, 0, 0, 0], 
[0, 0, 0, 0, 0, 0, 0, 0, 0, 0, 0, 0, 0, 0, 0, 0, 0, 0, 0, 0, 0, 0, 0, 0, 0, 0, 0, 0, 0, 0, 0, 0, 0, 0, 0, 0, 0, 0, 0, 0, 0, 0, 0, 0], 
[0, 0, 0, 0, 0, 0, 0, 0, 0, 0, 0, 0, 0, 0, 0, 0, 0, 0, 0, 0, 0, 0, 0, 0, 0, 0, 0, 0, 0, 0, 0, 0, 0, 0, 0, 0, 0, 0, 0, 0, 0, 0, 0, 0], 
[0, 0, 0, 0, 0, 0, 0, 0, 0, 0, 0, 0, 0, 0, 0, 0, 0, 0, 0, 0, 0, 0, 0, 0, 0, 0, 0, 0, 0, 0, 0, 0, 0, 0, 0, 0, 0, 0, 0, 0, 0, 0, 0, 0], 
[0, 0, 0, 0, 0, 0, 0, 0, 0, 0, 0, 0, 0, 0, 0, 2992, 2993, 2994, 2995, 2996, 0, 0, 0, 0, 0, 0, 0, 0, 3805, 3806, 3807, 0, 0, 0, 0, 0, 0, 0, 0, 0, 0, 0, 0, 0], 
[0, 0, 0, 0, 0, 0, 0, 0, 0, 0, 0, 0, 0, 0, 0, 3000, 3001, 3002, 3003, 3004, 3032, 3033, 3034, 3035, 0, 0, 0, 0, 3813, 3814, 3815, 0, 0, 0, 0, 0, 0, 0, 0, 0, 0, 0, 0, 0], 
[0, 0, 0, 0, 0, 0, 0, 0, 0, 0, 0, 0, 0, 0, 0, 3008, 3009, 3010, 3011, 3012, 3040, 3041, 3042, 3043, 0, 0, 0, 0, 0, 0, 0, 0, 0, 0, 0, 0, 0, 0, 0, 0, 0, 0, 0, 0], 
[0, 0, 0, 0, 0, 0, 0, 0, 0, 0, 0, 0, 0, 0, 0, 3016, 3017, 3018, 3019, 3020, 3048, 3049, 3050, 3051, 0, 0, 0, 0, 0, 0, 0, 0, 0, 0, 0, 0, 0, 0, 0, 0, 0, 0, 0, 0], 
[0, 0, 0, 0, 0, 0, 0, 0, 0, 0, 0, 0, 0, 0, 0, 3024, 3025, 3026, 3027, 3028, 3056, 3057, 3058, 3059, 0, 0, 0, 0, 0, 0, 0, 0, 0, 0, 0, 0, 0, 0, 0, 0, 0, 0, 0, 0], 
[0, 0, 0, 0, 0, 0, 0, 0, 0, 0, 0, 0, 0, 0, 0, 0, 0, 0, 0, 0, 0, 0, 0, 0, 0, 0, 0, 0, 0, 0, 0, 0, 0, 0, 0, 0, 0, 0, 0, 0, 0, 0, 0, 0], 
[0, 0, 0, 0, 0, 0, 0, 0, 0, 0, 0, 0, 0, 0, 0, 0, 0, 0, 0, 0, 0, 0, 0, 0, 0, 0, 0, 0, 0, 0, 0, 0, 0, 0, 0, 0, 0, 0, 0, 0, 0, 0, 0, 0], 
[0, 0, 0, 0, 0, 0, 0, 0, 0, 0, 0, 0, 0, 0, 0, 0, 0, 0, 0, 0, 0, 0, 0, 0, 0, 0, 0, 0, 0, 0, 0, 0, 0, 0, 0, 0, 0, 0, 0, 0, 0, 0, 0, 0], 
[0, 0, 0, 0, 0, 0, 0, 0, 0, 0, 0, 0, 0, 0, 0, 0, 0, 0, 0, 0, 0, 0, 0, 0, 0, 0, 0, 0, 0, 0, 0, 0, 0, 0, 0, 0, 0, 0, 0, 0, 0, 0, 0, 0], 
[0, 0, 0, 0, 0, 0, 0, 0, 0, 0, 0, 0, 0, 0, 0, 0, 0, 0, 0, 0, 0, 0, 0, 0, 0, 0, 0, 0, 0, 0, 0, 0, 0, 0, 0, 0, 0, 0, 0, 0, 0, 0, 0, 0], 
[0, 0, 0, 0, 0, 0, 3240, 3241, 3242, 3243, 3244, 3241, 3245, 0, 0, 0, 0, 0, 0, 0, 0, 0, 0, 4218, 0, 0, 0, 0, 0, 0, 0, 0, 0, 4219, 0, 0, 0, 0, 0, 0, 0, 0, 0, 0], 
[0, 0, 0, 0, 0, 0, 0, 0, 0, 0, 0, 0, 0, 0, 0, 0, 0, 0, 0, 0, 0, 0, 0, 0, 0, 0, 0, 0, 0, 0, 0, 0, 0, 0, 0, 0, 0, 0, 0, 0, 0, 0, 0, 0], 
[0, 0, 0, 0, 0, 0, 0, 0, 0, 0, 0, 0, 0, 0, 0, 0, 0, 0, 0, 0, 0, 0, 0, 4218, 0, 0, 0, 0, 0, 0, 0, 0, 0, 4219, 0, 0, 0, 0, 0, 0, 0, 0, 0, 0], 
[0, 0, 0, 0, 0, 0, 0, 0, 0, 0, 0, 0, 0, 0, 0, 0, 0, 0, 0, 0, 0, 0, 0, 0, 0, 0, 0, 0, 0, 0, 0, 0, 0, 0, 0, 0, 0, 0, 0, 0, 0, 0, 0, 0], 
[0, 0, 0, 0, 0, 0, 0, 0, 0, 0, 0, 0, 0, 0, 0, 0, 0, 0, 0, 0, 0, 0, 0, 0, 0, 0, 0, 0, 0, 0, 0, 0, 0, 0, 0, 0, 0, 0, 0, 0, 0, 0, 0, 0], 
[0, 0, 0, 0, 0, 0, 0, 0, 0, 0, 0, 0, 0, 0, 0, 0, 0, 0, 0, 0, 0, 0, 0, 0, 0, 0, 0, 0, 0, 0, 0, 0, 0, 0, 0, 0, 0, 0, 0, 0, 0, 0, 0, 0], 
[0, 0, 0, 0, 0, 0, 0, 0, 0, 0, 0, 0, 0, 0, 0, 0, 0, 0, 0, 0, 0, 0, 0, 0, 0, 0, 0, 0, 0, 0, 0, 0, 0, 0, 0, 0, 0, 0, 0, 0, 0, 0, 0, 0], 
[0, 0, 0, 0, 0, 0, 0, 0, 0, 0, 0, 0, 0, 0, 0, 0, 0, 0, 0, 0, 0, 0, 0, 0, 0, 0, 0, 0, 0, 0, 0, 0, 0, 0, 0, 0, 0, 0, 0, 0, 0, 0, 0, 0], 
[0, 0, 0, 0, 0, 0, 0, 0, 0, 0, 0, 0, 0, 0, 0, 0, 0, 0, 0, 0, 0, 0, 0, 0, 0, 0, 0, 0, 0, 0, 0, 0, 0, 0, 0, 0, 0, 0, 0, 0, 0, 0, 0, 0], 
[0, 0, 0, 0, 0, 0, 0, 0, 0, 0, 0, 0, 0, 0, 0, 0, 0, 0, 0, 0, 0, 0, 0, 0, 0, 0, 0, 0, 0, 0, 0, 0, 0, 0, 0, 0, 0, 0, 0, 0, 0, 0, 0, 0], 
[0, 0, 0, 0, 0, 0, 0, 0, 0, 0, 0, 0, 0, 0, 0, 0, 0, 0, 0, 0, 0, 0, 0, 0, 0, 0, 0, 0, 0, 0, 0, 0, 0, 0, 0, 0, 0, 0, 0, 0, 0, 0, 0, 0], 
[0, 0, 0, 0, 0, 0, 0, 0, 0, 0, 0, 0, 0, 0, 0, 0, 0, 0, 0, 0, 0, 0, 0, 0, 0, 0, 0, 0, 0, 0, 0, 0, 0, 0, 0, 0, 0, 0, 0, 0, 0, 0, 0, 0], 
[0, 0, 0, 0, 0, 0, 0, 0, 0, 0, 0, 0, 0, 0, 0, 0, 0, 0, 0, 0, 0, 0, 0, 0, 0, 0, 0, 0, 0, 0, 0, 0, 0, 0, 0, 0, 0, 0, 0, 0, 0, 0, 0, 0], 
[0, 0, 0, 0, 0, 0, 0, 0, 0, 0, 0, 0, 0, 0, 0, 0, 0, 0, 0, 0, 0, 0, 0, 0, 0, 0, 0, 0, 0, 0, 0, 0, 0, 0, 0, 0, 0, 0, 0, 0, 0, 0, 0, 0], 
[0, 0, 0, 0, 0, 0, 0, 0, 0, 0, 0, 0, 0, 0, 0, 0, 0, 0, 0, 0, 0, 0, 0, 0, 0, 0, 0, 0, 0, 0, 0, 0, 0, 0, 0, 0, 0, 0, 0, 0, 0, 0, 0, 0], 
[0, 0, 0, 0, 0, 0, 0, 0, 0, 0, 0, 0, 0, 0, 0, 0, 0, 0, 0, 0, 0, 0, 0, 0, 0, 0, 0, 0, 0, 0, 0, 0, 0, 0, 0, 0, 0, 0, 0, 0, 0, 0, 0, 0], 
[0, 0, 0, 0, 0, 0, 0, 0, 0, 0, 0, 0, 0, 0, 0, 0, 0, 0, 0, 0, 0, 0, 0, 0, 0, 0, 0, 0, 0, 0, 0, 0, 0, 0, 0, 0, 0, 0, 0, 0, 0, 0, 0, 0]]]
}
}
