{
	"Map": {
		"id": 57,
		"map_display_x": 0,
		"map_display_y": 0,
		"width": 20,
		"height": 15,
		"xsize": 20,
		"ysize": 15,
		"zsize": 3,
		"Name" : "Stadium Cup lobby",
		"Parent" : "Battle Tower",
		"Tileset" : "Trainer Tower interior",
		"BattleBack" : "",
		"Autoplay_bgm" : true,
		"BGM" : "PkmRS-BTower",
		"Autoplay_bgs" : false,
		"BGS" : "",
		"Encounter_list" : [],
		"Encounter_step" : 30,
		"table": [[[401, 402, 403, 404, 401, 384, 394, 394, 394, 394, 394, 394, 394, 389, 401, 402, 403, 404, 401, 394], 
[408, 410, 411, 412, 408, 392, 394, 394, 394, 394, 394, 394, 394, 397, 408, 410, 411, 412, 408, 394], 
[467, 457, 457, 457, 457, 392, 394, 394, 394, 394, 394, 394, 394, 397, 467, 457, 457, 457, 457, 394], 
[449, 449, 451, 449, 449, 392, 394, 394, 394, 394, 394, 394, 394, 397, 449, 449, 451, 449, 449, 394], 
[467, 457, 458, 465, 466, 392, 394, 394, 394, 394, 394, 394, 394, 397, 467, 457, 458, 465, 466, 394], 
[450, 440, 440, 440, 440, 400, 401, 401, 401, 401, 401, 401, 401, 405, 450, 440, 440, 440, 440, 394], 
[450, 440, 440, 440, 440, 408, 408, 408, 408, 408, 408, 408, 408, 408, 450, 440, 440, 440, 440, 394], 
[450, 440, 440, 440, 440, 449, 449, 449, 449, 467, 457, 449, 449, 449, 450, 440, 440, 440, 440, 394], 
[450, 429, 430, 431, 440, 449, 449, 449, 449, 449, 449, 449, 449, 449, 450, 429, 430, 431, 440, 394], 
[450, 437, 438, 439, 440, 447, 467, 457, 457, 457, 457, 457, 457, 457, 458, 437, 438, 439, 440, 394], 
[450, 440, 440, 440, 440, 440, 440, 440, 429, 430, 431, 440, 440, 440, 440, 440, 440, 440, 440, 394], 
[450, 440, 440, 440, 440, 440, 440, 440, 437, 438, 439, 440, 440, 440, 440, 440, 440, 440, 440, 394], 
[450, 440, 440, 440, 440, 440, 440, 440, 440, 440, 440, 440, 440, 440, 440, 440, 440, 440, 440, 394], 
[394, 394, 394, 394, 394, 394, 394, 394, 394, 394, 394, 394, 394, 394, 394, 394, 394, 394, 394, 394], 
[394, 394, 394, 394, 394, 394, 394, 394, 394, 394, 394, 394, 394, 394, 394, 394, 394, 394, 394, 394]], 

[[0, 0, 0, 0, 0, 0, 0, 0, 0, 0, 0, 0, 0, 0, 0, 0, 0, 0, 0, 0], 
[0, 0, 0, 0, 0, 0, 0, 0, 0, 0, 0, 0, 0, 0, 0, 0, 0, 0, 0, 0], 
[474, 506, 0, 504, 474, 0, 0, 0, 0, 0, 0, 0, 0, 0, 474, 506, 0, 504, 474, 0], 
[498, 514, 0, 512, 498, 0, 0, 0, 0, 0, 0, 0, 0, 0, 498, 514, 0, 512, 498, 0], 
[0, 0, 0, 0, 0, 0, 0, 0, 0, 0, 0, 0, 0, 0, 0, 0, 0, 0, 0, 0], 
[0, 0, 0, 0, 0, 0, 0, 0, 0, 418, 419, 0, 0, 0, 0, 0, 0, 0, 0, 0], 
[0, 0, 0, 0, 0, 409, 479, 485, 486, 426, 427, 487, 479, 409, 0, 0, 0, 0, 0, 0], 
[0, 0, 0, 0, 0, 425, 489, 493, 494, 505, 474, 495, 491, 425, 0, 0, 0, 0, 0, 0], 
[0, 0, 0, 0, 0, 433, 497, 498, 498, 513, 498, 498, 499, 433, 0, 0, 0, 0, 0, 0], 
[0, 0, 0, 0, 0, 0, 0, 0, 0, 0, 0, 0, 0, 0, 0, 0, 0, 0, 0, 0], 
[0, 0, 0, 0, 0, 0, 0, 0, 0, 0, 0, 0, 0, 0, 0, 0, 576, 577, 578, 0], 
[414, 0, 414, 0, 0, 0, 0, 0, 0, 0, 0, 0, 0, 0, 0, 0, 584, 585, 586, 0], 
[422, 0, 422, 0, 0, 0, 0, 0, 0, 0, 0, 0, 0, 0, 0, 0, 592, 593, 594, 0], 
[0, 0, 0, 0, 0, 0, 0, 0, 0, 0, 0, 0, 0, 0, 0, 0, 0, 0, 0, 0], 
[0, 0, 0, 0, 0, 0, 0, 0, 0, 0, 0, 0, 0, 0, 0, 0, 0, 0, 0, 0]], 

[[0, 0, 0, 0, 0, 0, 0, 0, 0, 0, 0, 0, 0, 0, 0, 0, 0, 0, 0, 0], 
[0, 0, 0, 0, 0, 0, 0, 0, 0, 0, 0, 0, 0, 0, 0, 0, 0, 0, 0, 0], 
[0, 0, 0, 0, 502, 0, 0, 0, 0, 0, 0, 0, 0, 0, 0, 0, 0, 0, 502, 0], 
[0, 0, 0, 0, 510, 0, 0, 0, 0, 0, 0, 0, 0, 0, 0, 0, 0, 0, 510, 0], 
[0, 0, 0, 0, 518, 0, 0, 0, 0, 0, 0, 0, 0, 0, 0, 0, 0, 0, 518, 0], 
[0, 0, 0, 0, 0, 0, 0, 0, 0, 0, 0, 0, 0, 0, 0, 0, 0, 0, 0, 0], 
[0, 0, 0, 0, 0, 0, 0, 0, 0, 0, 0, 0, 0, 0, 0, 0, 0, 0, 0, 0], 
[0, 0, 0, 0, 0, 526, 501, 0, 0, 0, 0, 0, 501, 503, 0, 0, 0, 0, 0, 0], 
[0, 0, 0, 0, 0, 534, 509, 0, 0, 0, 0, 0, 509, 511, 0, 0, 0, 0, 0, 0], 
[0, 0, 0, 0, 0, 542, 0, 0, 0, 0, 0, 0, 0, 519, 0, 0, 0, 0, 0, 0], 
[0, 0, 0, 0, 0, 0, 0, 0, 0, 0, 0, 0, 0, 0, 0, 0, 0, 0, 0, 0], 
[0, 0, 0, 0, 0, 0, 0, 0, 0, 0, 0, 0, 0, 0, 0, 0, 0, 0, 0, 0], 
[0, 0, 0, 0, 0, 0, 0, 0, 0, 0, 0, 0, 0, 0, 0, 0, 0, 0, 0, 0], 
[0, 0, 0, 0, 0, 0, 0, 0, 0, 0, 0, 0, 0, 0, 0, 0, 0, 0, 0, 0], 
[0, 0, 0, 0, 0, 0, 0, 0, 0, 0, 0, 0, 0, 0, 0, 0, 0, 0, 0, 0]]]
}
}
