{
	"Map": {
		"id": 63,
		"map_display_x": 0,
		"map_display_y": 0,
		"width": 20,
		"height": 15,
		"xsize": 20,
		"ysize": 15,
		"zsize": 3,
		"Name" : "Battle Factory intro corridor",
		"Parent" : "Battle Factory",
		"Tileset" : "Interior general",
		"BattleBack" : "",
		"Autoplay_bgm" : true,
		"BGM" : "PkmRS-BTower",
		"Autoplay_bgs" : false,
		"BGS" : "",
		"Encounter_list" : [],
		"Encounter_step" : 30,
		"table": [[[520, 521, 521, 521, 521, 521, 521, 521, 523, 542, 542, 542, 542, 542, 542, 542, 542, 542, 542, 542], 
[528, 529, 529, 529, 529, 529, 529, 529, 531, 542, 542, 542, 542, 542, 542, 542, 542, 542, 542, 542], 
[633, 641, 641, 641, 641, 641, 641, 641, 650, 542, 542, 542, 542, 542, 542, 542, 542, 542, 542, 542], 
[634, 624, 624, 624, 624, 624, 624, 624, 624, 542, 542, 542, 542, 542, 542, 542, 542, 542, 542, 542], 
[634, 624, 624, 624, 624, 624, 624, 624, 624, 542, 542, 542, 542, 542, 542, 542, 542, 542, 542, 542], 
[634, 624, 624, 624, 624, 624, 624, 624, 624, 542, 542, 542, 542, 542, 542, 542, 542, 542, 542, 542], 
[634, 624, 624, 624, 624, 624, 624, 624, 624, 542, 542, 542, 542, 542, 542, 542, 542, 542, 542, 542], 
[634, 624, 624, 624, 624, 624, 624, 624, 624, 542, 542, 542, 542, 542, 542, 542, 542, 542, 542, 542], 
[634, 624, 624, 624, 624, 624, 624, 624, 624, 542, 542, 542, 542, 542, 542, 542, 542, 542, 542, 542], 
[542, 542, 542, 542, 542, 542, 542, 542, 542, 542, 542, 542, 542, 542, 542, 542, 542, 542, 542, 542], 
[542, 542, 542, 542, 542, 542, 542, 542, 542, 542, 542, 542, 542, 542, 542, 542, 542, 542, 542, 542], 
[542, 542, 542, 542, 542, 542, 542, 542, 542, 542, 542, 542, 542, 542, 542, 542, 542, 542, 542, 542], 
[542, 542, 542, 542, 542, 542, 542, 542, 542, 542, 542, 542, 542, 542, 542, 542, 542, 542, 542, 542], 
[542, 542, 542, 542, 542, 542, 542, 542, 542, 542, 542, 542, 542, 542, 542, 542, 542, 542, 542, 542], 
[542, 542, 542, 542, 542, 542, 542, 542, 542, 542, 542, 542, 542, 542, 542, 542, 542, 542, 542, 542]], 

[[0, 0, 0, 389, 390, 391, 1788, 0, 0, 0, 0, 0, 0, 0, 0, 0, 0, 0, 0, 0], 
[0, 1794, 1795, 397, 398, 399, 1796, 1794, 0, 0, 0, 0, 0, 0, 0, 0, 0, 0, 0, 0], 
[536, 1802, 1803, 0, 0, 0, 1804, 1802, 539, 0, 0, 0, 0, 0, 0, 0, 0, 0, 0, 0], 
[1808, 1809, 0, 0, 0, 0, 0, 1789, 1790, 0, 0, 0, 0, 0, 0, 0, 0, 0, 0, 0], 
[1816, 1817, 1818, 0, 0, 0, 0, 1797, 1798, 0, 0, 0, 0, 0, 0, 0, 0, 0, 0, 0], 
[1824, 1825, 1826, 0, 0, 0, 0, 1805, 1806, 0, 0, 0, 0, 0, 0, 0, 0, 0, 0, 0], 
[1784, 1785, 0, 0, 0, 0, 0, 1784, 1785, 0, 0, 0, 0, 0, 0, 0, 0, 0, 0, 0], 
[1792, 1793, 0, 0, 0, 0, 0, 1792, 1793, 0, 0, 0, 0, 0, 0, 0, 0, 0, 0, 0], 
[1800, 1801, 0, 1245, 1246, 1247, 0, 1800, 1801, 0, 0, 0, 0, 0, 0, 0, 0, 0, 0, 0], 
[0, 0, 0, 1253, 1254, 1255, 0, 0, 0, 0, 0, 0, 0, 0, 0, 0, 0, 0, 0, 0], 
[0, 0, 0, 0, 0, 0, 0, 0, 0, 0, 0, 0, 0, 0, 0, 0, 0, 0, 0, 0], 
[0, 0, 0, 0, 0, 0, 0, 0, 0, 0, 0, 0, 0, 0, 0, 0, 0, 0, 0, 0], 
[0, 0, 0, 0, 0, 0, 0, 0, 0, 0, 0, 0, 0, 0, 0, 0, 0, 0, 0, 0], 
[0, 0, 0, 0, 0, 0, 0, 0, 0, 0, 0, 0, 0, 0, 0, 0, 0, 0, 0, 0], 
[0, 0, 0, 0, 0, 0, 0, 0, 0, 0, 0, 0, 0, 0, 0, 0, 0, 0, 0, 0]], 

[[0, 0, 0, 0, 0, 0, 0, 0, 0, 0, 0, 0, 0, 0, 0, 0, 0, 0, 0, 0], 
[0, 0, 0, 0, 0, 0, 0, 0, 0, 0, 0, 0, 0, 0, 0, 0, 0, 0, 0, 0], 
[0, 0, 0, 0, 0, 0, 0, 0, 0, 0, 0, 0, 0, 0, 0, 0, 0, 0, 0, 0], 
[0, 0, 0, 0, 0, 0, 0, 0, 0, 0, 0, 0, 0, 0, 0, 0, 0, 0, 0, 0], 
[0, 0, 0, 0, 0, 0, 0, 0, 0, 0, 0, 0, 0, 0, 0, 0, 0, 0, 0, 0], 
[0, 0, 0, 0, 0, 0, 0, 0, 0, 0, 0, 0, 0, 0, 0, 0, 0, 0, 0, 0], 
[0, 0, 0, 0, 0, 0, 0, 0, 0, 0, 0, 0, 0, 0, 0, 0, 0, 0, 0, 0], 
[0, 0, 0, 0, 0, 0, 0, 0, 0, 0, 0, 0, 0, 0, 0, 0, 0, 0, 0, 0], 
[0, 0, 0, 0, 0, 0, 0, 0, 0, 0, 0, 0, 0, 0, 0, 0, 0, 0, 0, 0], 
[0, 0, 0, 0, 0, 0, 0, 0, 0, 0, 0, 0, 0, 0, 0, 0, 0, 0, 0, 0], 
[0, 0, 0, 0, 0, 0, 0, 0, 0, 0, 0, 0, 0, 0, 0, 0, 0, 0, 0, 0], 
[0, 0, 0, 0, 0, 0, 0, 0, 0, 0, 0, 0, 0, 0, 0, 0, 0, 0, 0, 0], 
[0, 0, 0, 0, 0, 0, 0, 0, 0, 0, 0, 0, 0, 0, 0, 0, 0, 0, 0, 0], 
[0, 0, 0, 0, 0, 0, 0, 0, 0, 0, 0, 0, 0, 0, 0, 0, 0, 0, 0, 0], 
[0, 0, 0, 0, 0, 0, 0, 0, 0, 0, 0, 0, 0, 0, 0, 0, 0, 0, 0, 0]]]
}
}
