{
	"Map": {
		"id": 68,
		"map_display_x": 0,
		"map_display_y": 0,
		"width": 51,
		"height": 34,
		"xsize": 51,
		"ysize": 34,
		"zsize": 3,
		"Name" : "Safari Zone",
		"Parent" : "Safari Zone",
		"Tileset" : "Outside",
		"BattleBack" : "",
		"Autoplay_bgm" : true,
		"BGM" : "Safari",
		"Autoplay_bgs" : false,
		"BGS" : "",
		"Encounter_list" : [],
		"Encounter_step" : 30,
		"table": [[[960, 961, 962, 960, 961, 962, 960, 961, 962, 960, 961, 962, 976, 977, 978, 976, 977, 978, 960, 961, 962, 960, 961, 962, 960, 961, 962, 960, 961, 962, 976, 977, 978, 960, 961, 962, 960, 961, 962, 960, 961, 962, 960, 961, 962, 960, 961, 962, 960, 961, 962], 
[952, 953, 954, 952, 953, 954, 952, 953, 954, 952, 953, 954, 984, 985, 986, 984, 985, 986, 952, 953, 954, 952, 953, 954, 952, 953, 954, 952, 953, 954, 984, 985, 986, 952, 953, 954, 952, 953, 954, 952, 953, 954, 952, 953, 954, 952, 953, 954, 952, 953, 954], 
[960, 961, 962, 960, 961, 962, 960, 961, 962, 960, 961, 962, 944, 945, 946, 944, 945, 946, 960, 961, 962, 960, 961, 962, 960, 961, 962, 960, 961, 962, 944, 945, 946, 960, 961, 962, 960, 961, 962, 960, 961, 962, 960, 961, 962, 960, 961, 962, 976, 977, 978], 
[952, 953, 954, 952, 953, 954, 952, 953, 954, 952, 953, 954, 952, 953, 954, 952, 953, 954, 952, 953, 954, 952, 953, 954, 952, 953, 954, 952, 953, 954, 952, 953, 954, 952, 953, 954, 952, 953, 954, 952, 953, 954, 952, 953, 954, 952, 953, 954, 984, 985, 986], 
[960, 961, 962, 976, 977, 978, 960, 961, 962, 976, 977, 978, 976, 977, 978, 976, 977, 978, 976, 977, 978, 976, 977, 978, 976, 977, 978, 976, 977, 978, 976, 977, 978, 976, 977, 978, 976, 977, 978, 976, 977, 978, 960, 961, 962, 960, 961, 962, 944, 945, 946], 
[952, 953, 954, 984, 985, 986, 952, 953, 385, 995, 996, 997, 995, 996, 997, 995, 996, 997, 995, 996, 997, 995, 996, 997, 995, 996, 997, 995, 996, 997, 995, 996, 997, 995, 996, 997, 995, 996, 997, 995, 996, 997, 385, 953, 954, 952, 953, 954, 952, 953, 954], 
[976, 977, 978, 944, 945, 946, 960, 961, 385, 385, 385, 385, 385, 385, 385, 385, 385, 385, 385, 385, 385, 385, 385, 385, 385, 385, 385, 385, 385, 385, 385, 385, 385, 385, 385, 385, 385, 385, 385, 385, 385, 385, 385, 961, 962, 960, 961, 962, 960, 961, 962], 
[984, 985, 986, 952, 953, 954, 952, 953, 385, 385, 385, 385, 385, 385, 390, 390, 390, 390, 385, 385, 385, 385, 385, 385, 385, 385, 385, 385, 385, 385, 390, 390, 390, 390, 390, 385, 385, 385, 385, 537, 538, 539, 385, 953, 954, 952, 953, 954, 952, 953, 954], 
[944, 945, 946, 960, 961, 962, 960, 961, 385, 385, 385, 385, 390, 390, 390, 390, 390, 390, 390, 390, 385, 385, 385, 385, 385, 385, 385, 390, 390, 390, 390, 390, 390, 390, 390, 390, 390, 385, 537, 558, 546, 547, 385, 961, 962, 960, 961, 962, 960, 961, 962], 
[952, 953, 954, 952, 953, 954, 952, 953, 385, 385, 385, 390, 390, 390, 390, 390, 390, 390, 390, 390, 385, 385, 385, 385, 385, 385, 390, 390, 390, 390, 390, 390, 390, 390, 390, 390, 390, 390, 545, 546, 546, 547, 385, 953, 954, 952, 953, 954, 952, 953, 954], 
[960, 961, 962, 960, 961, 962, 960, 961, 385, 385, 385, 390, 390, 390, 390, 390, 390, 390, 390, 390, 385, 385, 385, 385, 385, 390, 390, 390, 390, 390, 390, 390, 390, 390, 390, 390, 390, 390, 545, 546, 546, 547, 385, 961, 962, 976, 977, 978, 960, 961, 962], 
[952, 953, 954, 952, 953, 954, 952, 953, 385, 385, 385, 390, 390, 390, 390, 390, 390, 390, 390, 385, 385, 385, 385, 385, 385, 390, 390, 390, 390, 390, 390, 390, 390, 390, 390, 390, 390, 537, 558, 546, 546, 547, 385, 953, 954, 984, 985, 986, 952, 953, 954], 
[960, 961, 962, 960, 961, 962, 960, 961, 385, 385, 385, 385, 390, 390, 390, 390, 390, 385, 385, 385, 385, 385, 385, 385, 385, 385, 390, 390, 390, 390, 385, 385, 385, 390, 390, 390, 385, 545, 546, 546, 546, 547, 385, 961, 962, 944, 945, 946, 960, 961, 962], 
[952, 953, 954, 952, 953, 954, 952, 953, 385, 385, 385, 385, 390, 390, 390, 385, 385, 390, 385, 385, 385, 385, 385, 385, 385, 385, 385, 385, 385, 385, 385, 385, 385, 385, 385, 385, 385, 553, 554, 554, 554, 555, 385, 953, 954, 952, 953, 954, 952, 953, 954], 
[960, 961, 962, 960, 961, 962, 960, 961, 385, 385, 385, 385, 385, 390, 385, 385, 390, 390, 385, 385, 385, 385, 385, 385, 385, 385, 385, 385, 385, 385, 385, 385, 385, 390, 390, 385, 385, 385, 385, 385, 385, 385, 385, 961, 962, 960, 961, 962, 960, 961, 962], 
[952, 953, 954, 952, 953, 954, 952, 953, 385, 385, 537, 539, 385, 385, 385, 385, 390, 390, 385, 385, 385, 385, 1232, 1233, 1233, 1233, 1233, 1233, 1234, 385, 385, 385, 385, 390, 390, 390, 390, 385, 385, 385, 385, 385, 385, 953, 954, 952, 953, 954, 952, 953, 954], 
[960, 961, 962, 976, 977, 978, 960, 961, 385, 385, 553, 551, 538, 539, 385, 390, 390, 390, 385, 385, 385, 385, 385, 385, 385, 385, 385, 385, 385, 385, 385, 385, 385, 385, 390, 390, 390, 390, 390, 385, 385, 385, 385, 961, 962, 960, 961, 962, 976, 977, 978], 
[952, 953, 954, 984, 985, 986, 952, 953, 385, 385, 385, 545, 546, 556, 539, 390, 390, 390, 385, 385, 385, 385, 385, 385, 385, 385, 385, 385, 385, 385, 385, 385, 385, 385, 390, 390, 390, 390, 390, 390, 390, 385, 385, 953, 954, 952, 953, 954, 984, 985, 986], 
[960, 961, 962, 944, 945, 946, 960, 961, 385, 385, 385, 553, 554, 554, 555, 385, 390, 390, 385, 385, 385, 385, 385, 385, 385, 385, 385, 385, 385, 385, 385, 385, 385, 385, 390, 390, 390, 390, 390, 390, 390, 385, 385, 961, 962, 960, 961, 962, 944, 945, 946], 
[952, 953, 954, 952, 953, 954, 952, 953, 385, 385, 385, 385, 385, 385, 385, 385, 385, 385, 1233, 1233, 1233, 1233, 1233, 1233, 1233, 1233, 1233, 1233, 1233, 1233, 1233, 1233, 385, 385, 385, 390, 390, 390, 390, 385, 385, 385, 385, 953, 954, 952, 953, 954, 952, 953, 954], 
[960, 961, 962, 960, 961, 962, 960, 961, 385, 385, 385, 385, 385, 385, 390, 390, 390, 390, 390, 390, 390, 390, 537, 538, 539, 385, 385, 385, 385, 385, 385, 385, 385, 385, 390, 390, 390, 390, 390, 390, 390, 385, 385, 961, 962, 976, 977, 978, 960, 961, 962], 
[952, 953, 954, 952, 953, 954, 952, 953, 385, 385, 385, 385, 385, 390, 390, 390, 390, 390, 390, 390, 390, 390, 553, 542, 556, 539, 385, 385, 385, 385, 385, 385, 385, 385, 390, 390, 390, 390, 390, 390, 385, 385, 385, 953, 954, 984, 985, 986, 952, 953, 954], 
[960, 961, 962, 960, 961, 962, 960, 961, 385, 385, 385, 385, 385, 390, 390, 390, 390, 390, 390, 390, 390, 390, 390, 553, 554, 555, 385, 385, 385, 385, 385, 385, 385, 390, 390, 390, 390, 390, 385, 385, 385, 385, 385, 961, 962, 944, 945, 946, 960, 961, 962], 
[952, 953, 954, 952, 953, 954, 952, 953, 385, 385, 385, 385, 385, 385, 390, 390, 390, 390, 390, 390, 390, 390, 385, 385, 385, 385, 385, 385, 385, 385, 385, 385, 385, 390, 390, 390, 390, 385, 385, 385, 385, 385, 385, 953, 954, 952, 953, 954, 952, 953, 954], 
[976, 977, 978, 960, 961, 962, 960, 961, 385, 385, 385, 385, 385, 385, 390, 390, 390, 390, 390, 390, 390, 390, 390, 390, 390, 385, 385, 385, 385, 385, 385, 385, 390, 390, 390, 390, 385, 385, 385, 385, 385, 385, 385, 961, 962, 960, 961, 962, 960, 961, 962], 
[984, 985, 986, 952, 953, 954, 952, 953, 385, 385, 385, 385, 385, 385, 385, 385, 390, 390, 390, 390, 390, 390, 390, 385, 385, 385, 385, 385, 385, 385, 385, 390, 390, 390, 390, 385, 385, 385, 385, 385, 385, 385, 385, 953, 954, 952, 953, 954, 952, 953, 954], 
[944, 945, 946, 960, 961, 962, 960, 961, 385, 385, 385, 385, 385, 385, 385, 385, 385, 385, 385, 385, 385, 385, 385, 385, 537, 538, 539, 385, 385, 385, 385, 385, 385, 385, 385, 385, 385, 385, 385, 385, 385, 385, 385, 961, 962, 976, 977, 978, 960, 961, 962], 
[952, 953, 954, 952, 953, 954, 952, 953, 385, 385, 385, 385, 385, 385, 385, 385, 385, 385, 385, 385, 385, 385, 385, 385, 545, 546, 547, 385, 385, 385, 385, 385, 385, 385, 385, 385, 385, 385, 385, 385, 385, 385, 385, 953, 954, 984, 985, 986, 952, 953, 954], 
[960, 961, 962, 960, 961, 962, 976, 977, 385, 385, 385, 385, 385, 385, 385, 385, 385, 385, 385, 385, 385, 385, 385, 385, 385, 385, 385, 385, 385, 385, 385, 385, 385, 385, 385, 385, 385, 385, 385, 385, 385, 385, 385, 961, 962, 944, 945, 946, 960, 961, 962], 
[952, 953, 954, 952, 953, 954, 984, 985, 986, 952, 953, 954, 952, 953, 954, 984, 985, 986, 952, 953, 385, 385, 385, 385, 385, 385, 385, 385, 385, 385, 385, 953, 954, 952, 953, 954, 984, 985, 986, 952, 953, 954, 952, 953, 954, 952, 953, 954, 952, 953, 954], 
[960, 961, 962, 960, 961, 962, 944, 945, 946, 960, 961, 962, 976, 977, 978, 944, 945, 946, 960, 961, 385, 385, 385, 385, 385, 385, 385, 385, 385, 385, 385, 961, 962, 960, 961, 962, 944, 945, 946, 960, 961, 962, 960, 961, 962, 960, 961, 962, 960, 961, 962], 
[952, 953, 954, 952, 953, 954, 952, 953, 954, 952, 953, 954, 984, 985, 986, 952, 953, 954, 952, 953, 385, 385, 385, 385, 385, 385, 385, 385, 385, 385, 385, 953, 954, 952, 953, 954, 952, 953, 954, 952, 953, 954, 952, 953, 954, 952, 953, 954, 952, 953, 954], 
[960, 961, 962, 960, 961, 962, 960, 961, 962, 960, 961, 962, 944, 945, 946, 960, 961, 962, 960, 961, 385, 385, 385, 385, 385, 385, 385, 385, 385, 385, 385, 961, 962, 960, 961, 962, 960, 961, 962, 976, 977, 978, 960, 961, 962, 960, 961, 962, 960, 961, 962], 
[952, 953, 954, 952, 953, 954, 952, 953, 954, 952, 953, 954, 952, 953, 954, 952, 953, 954, 952, 953, 385, 385, 385, 385, 385, 385, 385, 385, 385, 385, 385, 953, 954, 952, 953, 954, 952, 953, 954, 984, 985, 986, 952, 953, 954, 952, 953, 954, 952, 953, 954]], 

[[0, 0, 0, 0, 0, 0, 0, 0, 0, 0, 0, 0, 0, 0, 0, 0, 0, 0, 0, 0, 0, 0, 0, 0, 0, 0, 0, 0, 0, 0, 0, 0, 0, 0, 0, 0, 0, 0, 0, 0, 0, 0, 0, 0, 0, 0, 0, 0, 0, 0, 0], 
[0, 0, 0, 0, 0, 0, 0, 0, 0, 0, 0, 0, 0, 0, 0, 0, 0, 0, 0, 0, 0, 0, 0, 0, 0, 0, 0, 0, 0, 0, 0, 0, 0, 0, 0, 0, 0, 0, 0, 0, 0, 0, 0, 0, 0, 0, 0, 0, 0, 0, 0], 
[0, 0, 0, 0, 0, 0, 0, 0, 0, 0, 0, 0, 0, 0, 0, 0, 0, 0, 0, 0, 0, 0, 0, 0, 0, 0, 0, 0, 0, 0, 0, 0, 0, 0, 0, 0, 0, 0, 0, 0, 0, 0, 0, 0, 0, 0, 0, 0, 0, 0, 0], 
[0, 0, 0, 0, 0, 0, 0, 0, 0, 0, 0, 0, 0, 0, 0, 0, 0, 0, 0, 0, 0, 0, 0, 0, 0, 0, 0, 0, 0, 0, 0, 0, 0, 0, 0, 0, 0, 0, 0, 0, 0, 0, 0, 0, 0, 0, 0, 0, 0, 0, 0], 
[0, 0, 0, 0, 0, 0, 0, 0, 0, 0, 0, 0, 0, 0, 0, 0, 0, 0, 0, 0, 0, 0, 0, 0, 0, 0, 0, 0, 0, 0, 0, 0, 0, 0, 0, 0, 0, 0, 0, 0, 0, 0, 0, 0, 0, 0, 0, 0, 0, 0, 0], 
[0, 0, 0, 0, 0, 0, 0, 0, 973, 0, 0, 0, 0, 0, 0, 0, 0, 0, 0, 0, 0, 0, 0, 0, 0, 0, 0, 0, 0, 0, 0, 0, 0, 0, 0, 0, 0, 0, 0, 0, 0, 0, 971, 0, 0, 0, 0, 0, 0, 0, 0], 
[0, 0, 0, 0, 0, 0, 0, 0, 965, 0, 0, 0, 0, 0, 0, 0, 0, 0, 0, 0, 0, 0, 990, 0, 0, 0, 0, 0, 0, 0, 0, 0, 0, 0, 0, 0, 0, 0, 0, 0, 0, 0, 963, 0, 0, 0, 0, 0, 0, 0, 0], 
[0, 0, 0, 0, 0, 0, 0, 0, 973, 0, 0, 0, 0, 0, 0, 0, 0, 0, 0, 0, 0, 0, 990, 0, 0, 0, 0, 0, 0, 0, 0, 0, 0, 0, 0, 0, 0, 0, 0, 0, 0, 0, 971, 0, 0, 0, 0, 0, 0, 0, 0], 
[0, 0, 0, 0, 0, 0, 0, 0, 965, 0, 0, 0, 0, 0, 0, 0, 0, 0, 0, 0, 0, 0, 990, 0, 0, 0, 0, 0, 0, 0, 0, 0, 0, 0, 0, 0, 0, 0, 0, 0, 0, 0, 963, 0, 0, 0, 0, 0, 0, 0, 0], 
[0, 0, 0, 0, 0, 0, 0, 0, 973, 0, 0, 0, 0, 0, 0, 0, 0, 0, 0, 0, 0, 0, 0, 0, 0, 0, 0, 0, 0, 0, 0, 0, 0, 0, 0, 0, 0, 0, 0, 0, 0, 0, 971, 0, 0, 0, 0, 0, 0, 0, 0], 
[0, 0, 0, 0, 0, 0, 0, 0, 965, 0, 0, 0, 0, 0, 0, 0, 0, 0, 0, 0, 0, 0, 0, 0, 0, 0, 0, 0, 0, 0, 0, 0, 0, 0, 0, 0, 0, 0, 0, 0, 0, 0, 963, 0, 0, 0, 0, 0, 0, 0, 0], 
[0, 0, 0, 0, 0, 0, 0, 0, 973, 0, 0, 0, 0, 0, 0, 0, 0, 0, 0, 0, 0, 0, 990, 0, 0, 0, 0, 0, 0, 0, 0, 0, 0, 0, 0, 0, 0, 0, 0, 0, 0, 0, 971, 0, 0, 0, 0, 0, 0, 0, 0], 
[0, 0, 0, 0, 0, 0, 0, 0, 965, 0, 0, 0, 0, 0, 0, 0, 0, 0, 0, 0, 0, 0, 990, 0, 0, 0, 0, 0, 0, 0, 0, 0, 0, 0, 0, 0, 0, 0, 0, 0, 0, 0, 963, 0, 0, 0, 0, 0, 0, 0, 0], 
[0, 0, 0, 0, 0, 0, 0, 0, 973, 0, 0, 0, 0, 0, 0, 0, 0, 0, 82, 68, 68, 68, 68, 68, 68, 68, 68, 68, 68, 68, 68, 68, 84, 0, 0, 0, 0, 0, 0, 0, 0, 0, 971, 0, 0, 0, 0, 0, 0, 0, 0], 
[0, 0, 0, 0, 0, 0, 0, 0, 965, 0, 0, 0, 0, 0, 0, 0, 0, 0, 64, 48, 48, 52, 76, 76, 76, 76, 76, 76, 76, 56, 48, 48, 72, 0, 0, 0, 0, 990, 990, 990, 990, 990, 963, 0, 0, 0, 0, 0, 0, 0, 0], 
[0, 0, 0, 0, 0, 0, 0, 0, 973, 0, 0, 0, 0, 0, 0, 0, 0, 0, 64, 48, 48, 120, 0, 0, 0, 0, 0, 0, 0, 112, 48, 48, 72, 0, 0, 0, 0, 0, 0, 0, 0, 0, 971, 0, 0, 0, 0, 0, 0, 0, 0], 
[0, 0, 0, 0, 0, 0, 0, 0, 965, 0, 0, 0, 0, 0, 0, 0, 0, 0, 64, 48, 48, 72, 0, 0, 0, 0, 0, 0, 0, 64, 48, 48, 72, 0, 0, 0, 0, 0, 0, 0, 0, 0, 963, 0, 0, 0, 0, 0, 0, 0, 0], 
[0, 0, 0, 0, 0, 0, 0, 0, 973, 0, 0, 0, 0, 0, 0, 0, 0, 0, 64, 48, 48, 50, 68, 68, 68, 68, 68, 68, 68, 49, 48, 48, 72, 0, 0, 0, 0, 0, 0, 0, 0, 0, 971, 0, 0, 0, 0, 0, 0, 0, 0], 
[0, 0, 0, 0, 0, 0, 0, 0, 965, 0, 0, 0, 0, 0, 0, 0, 0, 0, 88, 76, 76, 76, 76, 76, 76, 76, 76, 76, 76, 76, 76, 76, 86, 0, 0, 0, 0, 0, 0, 0, 0, 0, 963, 0, 0, 0, 0, 0, 0, 0, 0], 
[0, 0, 0, 0, 0, 0, 0, 0, 973, 990, 990, 990, 990, 990, 990, 0, 0, 0, 0, 0, 0, 0, 0, 0, 0, 0, 0, 0, 990, 990, 0, 0, 0, 0, 0, 0, 0, 0, 0, 0, 0, 0, 971, 0, 0, 0, 0, 0, 0, 0, 0], 
[0, 0, 0, 0, 0, 0, 0, 0, 965, 0, 0, 0, 0, 0, 0, 0, 0, 0, 0, 0, 0, 0, 0, 0, 0, 0, 0, 0, 990, 990, 0, 0, 0, 0, 0, 0, 0, 0, 0, 0, 0, 0, 963, 0, 0, 0, 0, 0, 0, 0, 0], 
[0, 0, 0, 0, 0, 0, 0, 0, 973, 0, 0, 0, 0, 0, 0, 0, 0, 0, 0, 0, 0, 0, 0, 0, 0, 0, 0, 0, 0, 990, 0, 0, 0, 0, 0, 0, 0, 0, 0, 0, 0, 0, 971, 0, 0, 0, 0, 0, 0, 0, 0], 
[0, 0, 0, 0, 0, 0, 0, 0, 965, 0, 0, 0, 0, 0, 0, 0, 0, 0, 0, 0, 0, 0, 0, 0, 0, 0, 0, 0, 0, 990, 0, 0, 0, 0, 0, 0, 0, 0, 0, 0, 0, 0, 963, 0, 0, 0, 0, 0, 0, 0, 0], 
[0, 0, 0, 0, 0, 0, 0, 0, 973, 0, 0, 0, 0, 0, 0, 0, 0, 0, 0, 0, 0, 0, 0, 0, 0, 0, 0, 0, 0, 0, 0, 0, 0, 0, 0, 0, 0, 0, 0, 0, 0, 0, 971, 0, 0, 0, 0, 0, 0, 0, 0], 
[0, 0, 0, 0, 0, 0, 0, 0, 965, 0, 0, 0, 0, 0, 0, 0, 0, 0, 0, 0, 0, 0, 0, 0, 0, 0, 0, 0, 0, 0, 0, 0, 0, 0, 0, 0, 0, 0, 0, 0, 0, 0, 963, 0, 0, 0, 0, 0, 0, 0, 0], 
[0, 0, 0, 0, 0, 0, 0, 0, 973, 0, 0, 0, 0, 0, 0, 0, 0, 0, 0, 0, 0, 0, 0, 0, 0, 0, 0, 0, 0, 0, 0, 0, 0, 0, 0, 0, 0, 0, 0, 0, 0, 0, 971, 0, 0, 0, 0, 0, 0, 0, 0], 
[0, 0, 0, 0, 0, 0, 0, 0, 965, 947, 948, 949, 947, 948, 949, 947, 948, 949, 947, 948, 949, 0, 0, 0, 0, 0, 0, 0, 0, 0, 947, 948, 949, 947, 948, 949, 947, 948, 949, 947, 948, 949, 963, 0, 0, 0, 0, 0, 0, 0, 0], 
[0, 0, 0, 0, 0, 0, 0, 0, 973, 955, 956, 957, 955, 956, 957, 955, 956, 957, 955, 956, 973, 1717, 1717, 1717, 0, 0, 0, 1717, 1717, 1717, 955, 956, 973, 955, 956, 973, 955, 956, 973, 955, 956, 973, 971, 0, 0, 0, 0, 0, 0, 0, 0], 
[0, 0, 0, 0, 0, 0, 0, 0, 981, 963, 964, 965, 963, 964, 965, 979, 980, 981, 963, 964, 965, 1717, 0, 0, 0, 0, 0, 0, 0, 1717, 963, 964, 965, 963, 964, 965, 979, 980, 981, 963, 964, 965, 963, 0, 0, 0, 0, 0, 0, 0, 0], 
[0, 0, 0, 0, 0, 0, 0, 0, 0, 0, 0, 0, 0, 0, 0, 0, 0, 0, 0, 0, 973, 1717, 0, 0, 0, 0, 0, 0, 0, 1717, 955, 0, 0, 0, 0, 0, 0, 0, 0, 0, 0, 0, 0, 0, 0, 0, 0, 0, 0, 0, 0], 
[0, 0, 0, 0, 0, 0, 0, 0, 0, 0, 0, 0, 0, 0, 0, 0, 0, 0, 0, 0, 965, 1717, 0, 0, 0, 0, 0, 0, 0, 1717, 963, 0, 0, 0, 0, 0, 0, 0, 0, 0, 0, 0, 0, 0, 0, 0, 0, 0, 0, 0, 0], 
[0, 0, 0, 0, 0, 0, 0, 0, 0, 0, 0, 0, 0, 0, 0, 0, 0, 0, 0, 0, 973, 1717, 0, 0, 0, 0, 0, 0, 0, 1717, 955, 0, 0, 0, 0, 0, 0, 0, 0, 0, 0, 0, 0, 0, 0, 0, 0, 0, 0, 0, 0], 
[0, 0, 0, 0, 0, 0, 0, 0, 0, 0, 0, 0, 0, 0, 0, 0, 0, 0, 0, 0, 965, 1717, 0, 0, 0, 0, 0, 0, 0, 1717, 963, 0, 0, 0, 0, 0, 0, 0, 0, 0, 0, 0, 0, 0, 0, 0, 0, 0, 0, 0, 0], 
[0, 0, 0, 0, 0, 0, 0, 0, 0, 0, 0, 0, 0, 0, 0, 0, 0, 0, 0, 0, 973, 1717, 0, 0, 0, 0, 0, 0, 0, 1717, 955, 0, 0, 0, 0, 0, 0, 0, 0, 0, 0, 0, 0, 0, 0, 0, 0, 0, 0, 0, 0]], 

[[0, 0, 0, 0, 0, 0, 0, 0, 0, 0, 0, 0, 0, 0, 0, 0, 0, 0, 0, 0, 0, 0, 0, 0, 0, 0, 0, 0, 0, 0, 0, 0, 0, 0, 0, 0, 0, 0, 0, 0, 0, 0, 0, 0, 0, 0, 0, 0, 0, 0, 0], 
[0, 0, 0, 0, 0, 0, 0, 0, 0, 0, 0, 0, 0, 0, 0, 0, 0, 0, 0, 0, 0, 0, 0, 0, 0, 0, 0, 0, 0, 0, 0, 0, 0, 0, 0, 0, 0, 0, 0, 0, 0, 0, 0, 0, 0, 0, 0, 0, 0, 0, 0], 
[0, 0, 0, 0, 0, 0, 0, 0, 0, 0, 0, 0, 0, 0, 0, 0, 0, 0, 0, 0, 0, 0, 0, 0, 0, 0, 0, 0, 0, 0, 0, 0, 0, 0, 0, 0, 0, 0, 0, 0, 0, 0, 0, 0, 0, 0, 0, 0, 0, 0, 0], 
[0, 0, 0, 0, 0, 0, 0, 0, 0, 0, 0, 0, 0, 0, 0, 0, 0, 0, 0, 0, 0, 0, 0, 0, 0, 0, 0, 0, 0, 0, 0, 0, 0, 0, 0, 0, 0, 0, 0, 0, 0, 0, 0, 0, 0, 0, 0, 0, 0, 0, 0], 
[0, 0, 0, 0, 0, 0, 0, 0, 0, 0, 0, 0, 0, 0, 0, 0, 0, 0, 0, 0, 0, 0, 0, 0, 0, 0, 0, 0, 0, 0, 0, 0, 0, 0, 0, 0, 0, 0, 0, 0, 0, 0, 0, 0, 0, 0, 0, 0, 0, 0, 0], 
[0, 0, 0, 0, 0, 0, 0, 0, 0, 0, 0, 0, 0, 0, 0, 0, 0, 0, 0, 0, 0, 0, 0, 0, 0, 0, 0, 0, 0, 0, 0, 0, 0, 0, 0, 0, 0, 0, 0, 0, 0, 0, 0, 0, 0, 0, 0, 0, 0, 0, 0], 
[0, 0, 0, 0, 0, 0, 0, 0, 0, 0, 0, 0, 0, 0, 0, 0, 0, 0, 0, 0, 0, 0, 0, 0, 0, 0, 0, 0, 0, 0, 0, 0, 0, 0, 0, 0, 0, 0, 0, 0, 0, 0, 0, 0, 0, 0, 0, 0, 0, 0, 0], 
[0, 0, 0, 0, 0, 0, 0, 0, 0, 0, 0, 0, 0, 0, 0, 0, 0, 0, 0, 0, 0, 0, 0, 0, 0, 0, 0, 0, 0, 0, 0, 0, 0, 0, 0, 0, 0, 0, 0, 0, 0, 0, 0, 0, 0, 0, 0, 0, 0, 0, 0], 
[0, 0, 0, 0, 0, 0, 0, 0, 0, 0, 0, 0, 0, 0, 0, 0, 0, 0, 0, 0, 0, 0, 0, 0, 0, 0, 0, 0, 0, 0, 0, 0, 0, 0, 0, 0, 0, 0, 0, 0, 0, 0, 0, 0, 0, 0, 0, 0, 0, 0, 0], 
[0, 0, 0, 0, 0, 0, 0, 0, 0, 0, 0, 0, 0, 0, 0, 0, 0, 0, 0, 0, 0, 0, 0, 0, 0, 0, 0, 0, 0, 0, 0, 0, 0, 0, 0, 0, 0, 0, 0, 0, 0, 0, 0, 0, 0, 0, 0, 0, 0, 0, 0], 
[0, 0, 0, 0, 0, 0, 0, 0, 0, 0, 0, 0, 0, 0, 0, 0, 0, 0, 0, 0, 0, 0, 0, 0, 0, 0, 0, 0, 0, 0, 0, 0, 0, 0, 0, 0, 0, 0, 0, 0, 0, 0, 0, 0, 0, 0, 0, 0, 0, 0, 0], 
[0, 0, 0, 0, 0, 0, 0, 0, 0, 0, 0, 0, 0, 0, 0, 0, 0, 0, 0, 0, 0, 0, 0, 0, 0, 0, 0, 0, 0, 0, 0, 0, 0, 0, 0, 0, 0, 0, 0, 0, 0, 0, 0, 0, 0, 0, 0, 0, 0, 0, 0], 
[0, 0, 0, 0, 0, 0, 0, 0, 0, 0, 0, 0, 0, 0, 0, 0, 0, 0, 0, 0, 0, 0, 0, 0, 0, 0, 0, 0, 0, 0, 0, 0, 0, 0, 0, 0, 0, 0, 0, 0, 0, 0, 0, 0, 0, 0, 0, 0, 0, 0, 0], 
[0, 0, 0, 0, 0, 0, 0, 0, 0, 0, 0, 0, 0, 0, 0, 0, 0, 0, 0, 0, 0, 0, 0, 0, 0, 0, 0, 0, 0, 0, 0, 0, 0, 0, 0, 0, 0, 0, 0, 0, 0, 0, 0, 0, 0, 0, 0, 0, 0, 0, 0], 
[0, 0, 0, 0, 0, 0, 0, 0, 0, 0, 0, 0, 0, 0, 0, 0, 0, 0, 0, 0, 0, 0, 0, 0, 0, 0, 0, 0, 0, 0, 0, 0, 0, 0, 0, 0, 0, 0, 0, 0, 0, 0, 0, 0, 0, 0, 0, 0, 0, 0, 0], 
[0, 0, 0, 0, 0, 0, 0, 0, 0, 0, 0, 0, 0, 0, 0, 0, 0, 0, 0, 0, 0, 1131, 1115, 1115, 1115, 1115, 1115, 1115, 1115, 1132, 0, 0, 0, 0, 0, 0, 0, 0, 0, 0, 0, 0, 0, 0, 0, 0, 0, 0, 0, 0, 0], 
[0, 0, 0, 0, 0, 0, 0, 0, 0, 0, 0, 0, 0, 0, 0, 0, 0, 0, 0, 0, 0, 0, 0, 0, 0, 0, 0, 0, 0, 0, 0, 0, 0, 0, 0, 0, 0, 0, 0, 0, 0, 0, 0, 0, 0, 0, 0, 0, 0, 0, 0], 
[0, 0, 0, 0, 0, 0, 0, 0, 0, 0, 0, 0, 0, 0, 0, 0, 0, 0, 0, 0, 0, 0, 0, 0, 0, 0, 0, 0, 0, 0, 0, 0, 0, 0, 0, 0, 0, 0, 0, 0, 0, 0, 0, 0, 0, 0, 0, 0, 0, 0, 0], 
[0, 0, 0, 0, 0, 0, 0, 0, 0, 0, 0, 0, 0, 0, 0, 0, 0, 0, 0, 0, 0, 0, 0, 0, 0, 0, 0, 0, 0, 0, 0, 0, 0, 0, 0, 0, 0, 0, 0, 0, 0, 0, 0, 0, 0, 0, 0, 0, 0, 0, 0], 
[0, 0, 0, 0, 0, 0, 0, 0, 0, 0, 0, 0, 0, 0, 0, 0, 0, 0, 1115, 1115, 1115, 1115, 1115, 1115, 1115, 1115, 1115, 1115, 0, 0, 1115, 1115, 1115, 0, 0, 0, 0, 0, 0, 0, 0, 0, 0, 0, 0, 0, 0, 0, 0, 0, 0], 
[0, 0, 0, 0, 0, 0, 0, 0, 0, 0, 0, 0, 0, 0, 0, 0, 0, 0, 0, 0, 0, 0, 0, 0, 0, 0, 0, 0, 0, 0, 0, 0, 0, 0, 0, 0, 0, 0, 0, 0, 0, 0, 0, 0, 0, 0, 0, 0, 0, 0, 0], 
[0, 0, 0, 0, 0, 0, 0, 0, 0, 0, 0, 0, 0, 0, 0, 0, 0, 0, 0, 0, 0, 0, 0, 0, 0, 0, 0, 0, 0, 0, 0, 0, 0, 0, 0, 0, 0, 0, 0, 0, 0, 0, 0, 0, 0, 0, 0, 0, 0, 0, 0], 
[0, 0, 0, 0, 0, 0, 0, 0, 0, 0, 0, 0, 0, 0, 0, 0, 0, 0, 0, 0, 0, 0, 0, 0, 0, 0, 0, 0, 0, 0, 0, 0, 0, 0, 0, 0, 0, 0, 0, 0, 0, 0, 0, 0, 0, 0, 0, 0, 0, 0, 0], 
[0, 0, 0, 0, 0, 0, 0, 0, 0, 0, 0, 0, 0, 0, 0, 0, 0, 0, 0, 0, 0, 0, 0, 0, 0, 0, 0, 0, 0, 0, 0, 0, 0, 0, 0, 0, 0, 0, 0, 0, 0, 0, 0, 0, 0, 0, 0, 0, 0, 0, 0], 
[0, 0, 0, 0, 0, 0, 0, 0, 0, 0, 0, 0, 0, 0, 0, 0, 0, 0, 0, 0, 0, 0, 0, 0, 0, 0, 0, 0, 0, 0, 0, 0, 0, 0, 0, 0, 0, 0, 0, 0, 0, 0, 0, 0, 0, 0, 0, 0, 0, 0, 0], 
[0, 0, 0, 0, 0, 0, 0, 0, 0, 0, 0, 0, 0, 0, 0, 0, 0, 0, 0, 0, 0, 0, 0, 0, 0, 0, 0, 0, 0, 0, 0, 0, 0, 0, 0, 0, 0, 0, 0, 0, 0, 0, 0, 0, 0, 0, 0, 0, 0, 0, 0], 
[0, 0, 0, 0, 0, 0, 0, 0, 0, 0, 0, 0, 0, 0, 0, 0, 0, 0, 0, 0, 0, 0, 0, 0, 0, 0, 0, 0, 0, 0, 0, 0, 0, 0, 0, 0, 0, 0, 0, 0, 0, 0, 0, 0, 0, 0, 0, 0, 0, 0, 0], 
[0, 0, 0, 0, 0, 0, 0, 0, 0, 0, 0, 0, 0, 0, 0, 0, 0, 0, 0, 0, 0, 0, 2664, 2668, 2665, 2666, 2667, 2668, 2669, 0, 0, 0, 0, 0, 0, 0, 0, 0, 0, 0, 0, 0, 0, 0, 0, 0, 0, 0, 0, 0, 0], 
[0, 0, 0, 0, 0, 0, 0, 0, 0, 0, 0, 0, 0, 0, 0, 0, 0, 0, 0, 0, 0, 0, 2640, 2641, 2642, 2643, 2642, 2643, 2644, 0, 0, 0, 0, 0, 0, 0, 0, 0, 0, 0, 0, 0, 0, 0, 0, 0, 0, 0, 0, 0, 0], 
[0, 0, 0, 0, 0, 0, 0, 0, 0, 0, 0, 0, 0, 0, 0, 0, 0, 0, 0, 0, 0, 0, 2640, 2641, 2642, 2643, 2642, 2643, 2644, 0, 0, 0, 0, 0, 0, 0, 0, 0, 0, 0, 0, 0, 0, 0, 0, 0, 0, 0, 0, 0, 0], 
[0, 0, 0, 0, 0, 0, 0, 0, 0, 0, 0, 0, 0, 0, 0, 0, 0, 0, 0, 0, 0, 0, 2640, 2641, 2642, 2643, 2642, 2643, 2644, 0, 0, 0, 0, 0, 0, 0, 0, 0, 0, 0, 0, 0, 0, 0, 0, 0, 0, 0, 0, 0, 0], 
[0, 0, 0, 0, 0, 0, 0, 0, 0, 0, 0, 0, 0, 0, 0, 0, 0, 0, 0, 0, 0, 0, 2640, 2641, 2642, 2643, 2642, 2643, 2644, 0, 0, 0, 0, 0, 0, 0, 0, 0, 0, 0, 0, 0, 0, 0, 0, 0, 0, 0, 0, 0, 0], 
[0, 0, 0, 0, 0, 0, 0, 0, 0, 0, 0, 0, 0, 0, 0, 0, 0, 0, 0, 0, 0, 0, 2640, 2641, 2642, 2643, 2642, 2643, 2644, 0, 0, 0, 0, 0, 0, 0, 0, 0, 0, 0, 0, 0, 0, 0, 0, 0, 0, 0, 0, 0, 0], 
[0, 0, 0, 0, 0, 0, 0, 0, 0, 0, 0, 0, 0, 0, 0, 0, 0, 0, 0, 0, 0, 0, 2640, 2641, 2642, 2643, 2642, 2643, 2644, 0, 0, 0, 0, 0, 0, 0, 0, 0, 0, 0, 0, 0, 0, 0, 0, 0, 0, 0, 0, 0, 0]]]
}
}
