{
	"Map": {
		"id": 74,
		"map_display_x": 0,
		"map_display_y": 0,
		"width": 20,
		"height": 15,
		"xsize": 20,
		"ysize": 15,
		"zsize": 3,
		"Name" : "Cycling Road gate",
		"Parent" : "Route 6",
		"Tileset" : "Interior general",
		"BattleBack" : "",
		"Autoplay_bgm" : true,
		"BGM" : "route",
		"Autoplay_bgs" : false,
		"BGS" : "",
		"Encounter_list" : [],
		"Encounter_step" : 30,
		"table": [[[542, 2184, 2184, 2185, 2186, 2184, 2184, 2184, 2189, 2190, 2184, 2184, 542, 542, 542, 542, 542, 542, 542, 542], 
[542, 2192, 2192, 2193, 2194, 2192, 2192, 2192, 2197, 2198, 2192, 2192, 542, 542, 542, 542, 542, 542, 542, 542], 
[542, 2221, 2221, 2221, 2221, 2221, 2221, 2221, 2221, 2221, 2221, 2221, 542, 542, 542, 542, 542, 542, 542, 542], 
[542, 2221, 2221, 2221, 2221, 2221, 2221, 2221, 2221, 2221, 2221, 2222, 542, 542, 542, 542, 542, 542, 542, 542], 
[542, 2221, 2229, 2229, 2229, 2229, 2229, 2229, 2229, 2229, 2229, 2230, 542, 542, 542, 542, 542, 542, 542, 542], 
[542, 2221, 2212, 2212, 2212, 2212, 2212, 2212, 2212, 2212, 2212, 2212, 542, 542, 542, 542, 542, 542, 542, 542], 
[542, 2221, 2212, 2212, 2212, 2212, 2212, 2212, 2212, 2212, 2212, 2212, 542, 542, 542, 542, 542, 542, 542, 542], 
[542, 2221, 2212, 2212, 2212, 2212, 2212, 2212, 2212, 2212, 2212, 2212, 542, 542, 542, 542, 542, 542, 542, 542], 
[542, 2221, 2212, 2212, 2212, 2212, 2212, 2212, 2212, 2212, 2212, 2212, 542, 542, 542, 542, 542, 542, 542, 542], 
[542, 2221, 2221, 2221, 2221, 2221, 2221, 2221, 2221, 2221, 2221, 2222, 542, 542, 542, 542, 542, 542, 542, 542], 
[542, 2221, 2229, 2229, 2229, 2229, 2229, 2229, 2229, 2229, 2229, 2230, 542, 542, 542, 542, 542, 542, 542, 542], 
[542, 542, 542, 542, 542, 542, 542, 542, 542, 542, 542, 542, 542, 542, 542, 542, 542, 542, 542, 542], 
[542, 542, 542, 542, 542, 542, 542, 542, 542, 542, 542, 542, 542, 542, 542, 542, 542, 542, 542, 542], 
[542, 542, 542, 542, 542, 542, 542, 542, 542, 542, 542, 542, 542, 542, 542, 542, 542, 542, 542, 542], 
[542, 542, 542, 542, 542, 542, 542, 542, 542, 542, 542, 542, 542, 542, 542, 542, 542, 542, 542, 542]], 

[[0, 0, 0, 0, 0, 0, 0, 0, 0, 0, 0, 0, 0, 0, 0, 0, 0, 0, 0, 0], 
[0, 1770, 0, 0, 0, 0, 0, 0, 0, 0, 0, 1770, 0, 0, 0, 0, 0, 0, 0, 0], 
[0, 1778, 2001, 2002, 2002, 2002, 2002, 2002, 2002, 2002, 2003, 1778, 0, 0, 0, 0, 0, 0, 0, 0], 
[0, 0, 2025, 2026, 2026, 2026, 2026, 2026, 2026, 2026, 2027, 0, 0, 0, 0, 0, 0, 0, 0, 0], 
[0, 0, 0, 0, 0, 0, 0, 0, 0, 0, 0, 0, 0, 0, 0, 0, 0, 0, 0, 0], 
[1222, 1223, 1216, 1217, 1217, 1217, 1217, 1217, 1217, 1217, 1218, 1198, 1199, 0, 0, 0, 0, 0, 0, 0], 
[1230, 1231, 1224, 1225, 1225, 1225, 1225, 1225, 1225, 1225, 1226, 1206, 1207, 0, 0, 0, 0, 0, 0, 0], 
[1238, 1239, 1232, 1233, 1233, 1233, 1233, 1233, 1233, 1233, 1234, 1214, 1215, 0, 0, 0, 0, 0, 0, 0], 
[0, 0, 2001, 2002, 2002, 2002, 2002, 2002, 2002, 2002, 2003, 0, 0, 0, 0, 0, 0, 0, 0, 0], 
[0, 1770, 2025, 2026, 2026, 2026, 2026, 2026, 2026, 2026, 2027, 1770, 0, 0, 0, 0, 0, 0, 0, 0], 
[0, 1778, 0, 0, 0, 0, 0, 0, 0, 0, 0, 1778, 0, 0, 0, 0, 0, 0, 0, 0], 
[0, 0, 0, 0, 0, 0, 0, 0, 0, 0, 0, 0, 0, 0, 0, 0, 0, 0, 0, 0], 
[0, 0, 0, 0, 0, 0, 0, 0, 0, 0, 0, 0, 0, 0, 0, 0, 0, 0, 0, 0], 
[0, 0, 0, 0, 0, 0, 0, 0, 0, 0, 0, 0, 0, 0, 0, 0, 0, 0, 0, 0], 
[0, 0, 0, 0, 0, 0, 0, 0, 0, 0, 0, 0, 0, 0, 0, 0, 0, 0, 0, 0]], 

[[0, 0, 0, 0, 0, 0, 0, 0, 0, 0, 0, 0, 0, 0, 0, 0, 0, 0, 0, 0], 
[0, 0, 0, 0, 0, 0, 0, 0, 0, 0, 0, 0, 0, 0, 0, 0, 0, 0, 0, 0], 
[0, 0, 0, 0, 0, 0, 0, 0, 0, 0, 0, 0, 0, 0, 0, 0, 0, 0, 0, 0], 
[0, 0, 0, 0, 0, 0, 0, 0, 0, 0, 0, 0, 0, 0, 0, 0, 0, 0, 0, 0], 
[0, 0, 0, 0, 0, 0, 0, 0, 0, 0, 0, 0, 0, 0, 0, 0, 0, 0, 0, 0], 
[0, 0, 0, 0, 0, 0, 0, 0, 0, 0, 0, 0, 0, 0, 0, 0, 0, 0, 0, 0], 
[0, 0, 0, 0, 0, 0, 0, 0, 0, 0, 0, 0, 0, 0, 0, 0, 0, 0, 0, 0], 
[0, 0, 0, 0, 0, 0, 0, 0, 0, 0, 0, 0, 0, 0, 0, 0, 0, 0, 0, 0], 
[0, 0, 0, 0, 0, 0, 0, 0, 0, 0, 0, 0, 0, 0, 0, 0, 0, 0, 0, 0], 
[0, 0, 0, 0, 0, 0, 0, 0, 0, 0, 0, 0, 0, 0, 0, 0, 0, 0, 0, 0], 
[0, 0, 0, 0, 0, 0, 0, 0, 0, 0, 0, 0, 0, 0, 0, 0, 0, 0, 0, 0], 
[0, 0, 0, 0, 0, 0, 0, 0, 0, 0, 0, 0, 0, 0, 0, 0, 0, 0, 0, 0], 
[0, 0, 0, 0, 0, 0, 0, 0, 0, 0, 0, 0, 0, 0, 0, 0, 0, 0, 0, 0], 
[0, 0, 0, 0, 0, 0, 0, 0, 0, 0, 0, 0, 0, 0, 0, 0, 0, 0, 0, 0], 
[0, 0, 0, 0, 0, 0, 0, 0, 0, 0, 0, 0, 0, 0, 0, 0, 0, 0, 0, 0]]]
}
}
