{
	"Map": {
		"id": 66,
		"map_display_x": 0,
		"map_display_y": 0,
		"width": 22,
		"height": 21,
		"xsize": 22,
		"ysize": 21,
		"zsize": 3,
		"Name" : "Safari Zone",
		"Parent" : "",
		"Tileset" : "Outside",
		"BattleBack" : "",
		"Autoplay_bgm" : true,
		"BGM" : "route",
		"Autoplay_bgs" : false,
		"BGS" : "",
		"Encounter_list" : [],
		"Encounter_step" : 30,
		"table": [[[808, 809, 808, 809, 808, 809, 808, 809, 808, 811, 385, 385, 385, 385, 385, 385, 810, 809, 808, 809, 808, 809], 
[800, 801, 800, 801, 800, 801, 800, 801, 800, 803, 385, 385, 385, 385, 385, 385, 802, 801, 800, 801, 800, 801], 
[808, 809, 808, 809, 808, 809, 808, 809, 808, 811, 385, 385, 385, 385, 385, 385, 810, 809, 808, 809, 808, 809], 
[800, 801, 800, 801, 800, 801, 800, 801, 800, 803, 385, 385, 385, 385, 385, 385, 802, 801, 800, 801, 800, 801], 
[808, 809, 808, 809, 808, 809, 808, 809, 808, 811, 385, 385, 385, 385, 385, 385, 810, 809, 808, 809, 808, 809], 
[800, 801, 800, 801, 800, 801, 800, 803, 818, 819, 385, 385, 385, 385, 385, 385, 818, 819, 802, 801, 800, 801], 
[808, 809, 808, 809, 808, 809, 808, 811, 386, 385, 385, 385, 385, 385, 385, 385, 385, 386, 810, 809, 808, 809], 
[800, 801, 800, 801, 800, 801, 800, 803, 388, 389, 385, 385, 385, 385, 385, 385, 387, 389, 818, 819, 818, 819], 
[808, 809, 808, 809, 808, 809, 808, 811, 386, 385, 387, 545, 546, 547, 389, 388, 386, 385, 385, 386, 388, 387], 
[800, 801, 800, 801, 800, 801, 800, 803, 387, 389, 386, 553, 554, 555, 387, 385, 385, 387, 389, 385, 387, 385], 
[808, 809, 808, 809, 808, 809, 808, 811, 390, 386, 387, 385, 388, 385, 386, 388, 388, 386, 388, 386, 385, 388], 
[800, 801, 800, 801, 800, 801, 800, 803, 390, 390, 390, 389, 386, 387, 389, 387, 385, 387, 385, 387, 385, 385], 
[808, 809, 808, 809, 808, 809, 808, 811, 390, 390, 390, 390, 390, 390, 390, 390, 390, 390, 810, 811, 810, 811], 
[800, 801, 800, 801, 800, 801, 800, 803, 390, 390, 390, 390, 390, 390, 390, 390, 390, 390, 802, 801, 800, 801], 
[808, 809, 808, 809, 808, 809, 808, 811, 810, 811, 810, 811, 810, 811, 810, 811, 810, 811, 810, 809, 808, 809], 
[800, 801, 800, 801, 800, 801, 800, 801, 800, 801, 800, 801, 800, 801, 800, 801, 800, 801, 800, 801, 800, 801], 
[808, 809, 808, 809, 808, 809, 808, 809, 808, 809, 808, 809, 808, 809, 808, 809, 808, 809, 808, 809, 808, 809], 
[800, 801, 800, 801, 800, 801, 800, 801, 800, 801, 800, 801, 800, 801, 800, 801, 800, 801, 800, 801, 800, 801], 
[808, 809, 808, 809, 808, 809, 808, 809, 808, 809, 808, 809, 808, 809, 808, 809, 808, 809, 808, 809, 808, 809], 
[800, 801, 800, 801, 800, 801, 800, 801, 800, 801, 800, 801, 800, 801, 800, 801, 800, 801, 800, 801, 800, 801], 
[808, 809, 808, 809, 808, 809, 808, 809, 808, 809, 808, 809, 808, 809, 808, 809, 808, 809, 808, 809, 808, 809]], 

[[0, 0, 0, 0, 0, 0, 0, 0, 0, 0, 2640, 2641, 2641, 2642, 2643, 2644, 0, 0, 0, 0, 0, 0], 
[0, 0, 0, 0, 0, 0, 0, 0, 0, 0, 2640, 2641, 2641, 2642, 2643, 2644, 0, 0, 0, 0, 0, 0], 
[0, 0, 0, 0, 0, 0, 0, 0, 0, 0, 2640, 2641, 2641, 2642, 2643, 2644, 0, 0, 0, 0, 0, 0], 
[0, 0, 0, 0, 0, 0, 0, 0, 0, 0, 2640, 2641, 2641, 2642, 2643, 2644, 0, 0, 0, 0, 0, 0], 
[0, 0, 0, 0, 0, 0, 0, 0, 0, 0, 2640, 2641, 2641, 2642, 2643, 2644, 0, 0, 0, 0, 0, 0], 
[0, 0, 0, 0, 0, 0, 0, 0, 0, 0, 2672, 2673, 2674, 2675, 2676, 2677, 0, 0, 0, 0, 0, 0], 
[0, 0, 0, 0, 0, 0, 0, 0, 1065, 1065, 2680, 2681, 2682, 2683, 2684, 2685, 1065, 1065, 0, 0, 0, 0], 
[0, 0, 0, 0, 0, 0, 0, 0, 0, 0, 2688, 2689, 2690, 2691, 2692, 2693, 0, 0, 0, 0, 0, 0], 
[0, 0, 0, 0, 0, 0, 0, 0, 0, 0, 0, 2697, 0, 2699, 0, 0, 0, 0, 0, 0, 0, 0], 
[0, 0, 0, 0, 0, 0, 0, 0, 0, 1680, 1682, 0, 0, 0, 1680, 1681, 1682, 0, 0, 0, 0, 0], 
[0, 0, 0, 0, 0, 0, 0, 0, 0, 0, 0, 0, 0, 0, 0, 0, 0, 0, 0, 0, 0, 0], 
[0, 0, 0, 0, 0, 0, 0, 0, 0, 0, 0, 0, 0, 0, 0, 0, 0, 0, 0, 0, 0, 0], 
[0, 0, 0, 0, 0, 0, 0, 0, 0, 0, 0, 0, 0, 0, 0, 0, 0, 0, 0, 0, 0, 0], 
[0, 0, 0, 0, 0, 0, 0, 0, 0, 0, 0, 0, 0, 0, 0, 0, 0, 0, 0, 0, 0, 0], 
[0, 0, 0, 0, 0, 0, 0, 0, 0, 0, 0, 0, 0, 0, 0, 0, 0, 0, 0, 0, 0, 0], 
[0, 0, 0, 0, 0, 0, 0, 0, 0, 0, 0, 0, 0, 0, 0, 0, 0, 0, 0, 0, 0, 0], 
[0, 0, 0, 0, 0, 0, 0, 0, 0, 0, 0, 0, 0, 0, 0, 0, 0, 0, 0, 0, 0, 0], 
[0, 0, 0, 0, 0, 0, 0, 0, 0, 0, 0, 0, 0, 0, 0, 0, 0, 0, 0, 0, 0, 0], 
[0, 0, 0, 0, 0, 0, 0, 0, 0, 0, 0, 0, 0, 0, 0, 0, 0, 0, 0, 0, 0, 0], 
[0, 0, 0, 0, 0, 0, 0, 0, 0, 0, 0, 0, 0, 0, 0, 0, 0, 0, 0, 0, 0, 0], 
[0, 0, 0, 0, 0, 0, 0, 0, 0, 0, 0, 0, 0, 0, 0, 0, 0, 0, 0, 0, 0, 0]], 

[[0, 0, 0, 0, 0, 0, 0, 0, 0, 0, 0, 0, 0, 0, 0, 0, 0, 0, 0, 0, 0, 0], 
[0, 0, 0, 0, 0, 0, 0, 0, 0, 0, 0, 0, 0, 0, 0, 0, 0, 0, 0, 0, 0, 0], 
[0, 0, 0, 0, 0, 0, 0, 0, 0, 0, 0, 0, 0, 0, 0, 0, 0, 0, 0, 0, 0, 0], 
[0, 0, 0, 0, 0, 0, 0, 0, 0, 0, 0, 0, 0, 0, 0, 0, 0, 0, 0, 0, 0, 0], 
[0, 0, 0, 0, 0, 0, 0, 0, 0, 0, 0, 0, 0, 0, 0, 0, 0, 0, 0, 0, 0, 0], 
[0, 0, 0, 0, 0, 0, 0, 0, 0, 0, 0, 0, 0, 0, 0, 0, 0, 0, 0, 0, 0, 0], 
[0, 0, 0, 0, 0, 0, 0, 0, 0, 0, 0, 0, 0, 0, 0, 0, 0, 0, 0, 0, 0, 0], 
[0, 0, 0, 0, 0, 0, 0, 0, 0, 0, 0, 0, 0, 0, 0, 0, 0, 0, 0, 0, 0, 0], 
[0, 0, 0, 0, 0, 0, 0, 0, 0, 0, 0, 0, 0, 0, 0, 0, 0, 0, 0, 0, 0, 0], 
[0, 0, 0, 0, 0, 0, 0, 0, 0, 0, 0, 0, 0, 0, 0, 0, 0, 0, 0, 0, 0, 0], 
[0, 0, 0, 0, 0, 0, 0, 0, 0, 0, 0, 0, 0, 0, 0, 0, 0, 0, 0, 0, 0, 0], 
[0, 0, 0, 0, 0, 0, 0, 0, 0, 0, 0, 0, 0, 0, 0, 0, 0, 0, 804, 805, 804, 805], 
[0, 0, 0, 0, 0, 0, 0, 0, 0, 0, 0, 0, 0, 0, 0, 0, 0, 0, 0, 0, 0, 0], 
[0, 0, 0, 0, 0, 0, 0, 0, 804, 805, 804, 805, 804, 805, 804, 805, 804, 805, 0, 0, 0, 0], 
[0, 0, 0, 0, 0, 0, 0, 0, 0, 0, 0, 0, 0, 0, 0, 0, 0, 0, 0, 0, 0, 0], 
[0, 0, 0, 0, 0, 0, 0, 0, 0, 0, 0, 0, 0, 0, 0, 0, 0, 0, 0, 0, 0, 0], 
[0, 0, 0, 0, 0, 0, 0, 0, 0, 0, 0, 0, 0, 0, 0, 0, 0, 0, 0, 0, 0, 0], 
[0, 0, 0, 0, 0, 0, 0, 0, 0, 0, 0, 0, 0, 0, 0, 0, 0, 0, 0, 0, 0, 0], 
[0, 0, 0, 0, 0, 0, 0, 0, 0, 0, 0, 0, 0, 0, 0, 0, 0, 0, 0, 0, 0, 0], 
[0, 0, 0, 0, 0, 0, 0, 0, 0, 0, 0, 0, 0, 0, 0, 0, 0, 0, 0, 0, 0, 0], 
[0, 0, 0, 0, 0, 0, 0, 0, 0, 0, 0, 0, 0, 0, 0, 0, 0, 0, 0, 0, 0, 0]]]
}
}
