{
	"Map": {
		"id": 26,
		"map_display_x": 0,
		"map_display_y": 0,
		"width": 20,
		"height": 15,
		"xsize": 20,
		"ysize": 15,
		"zsize": 3,
		"Name" : "Pokémon Fan Club",
		"Parent" : "Lerucean Town",
		"Tileset" : "Interior general",
		"BattleBack" : "",
		"Autoplay_bgm" : true,
		"BGM" : "021-Field04",
		"Autoplay_bgs" : false,
		"BGS" : "",
		"Encounter_list" : [],
		"Encounter_step" : 30,
		"table": [[[437, 438, 438, 438, 438, 438, 438, 438, 438, 438, 438, 439, 542, 542, 542, 542, 542, 542, 542, 542], 
[445, 446, 446, 446, 446, 446, 446, 446, 446, 446, 446, 447, 542, 542, 542, 542, 542, 542, 542, 542], 
[1033, 1041, 1041, 1041, 1033, 1033, 1033, 1033, 1035, 1041, 1041, 1027, 542, 542, 542, 542, 542, 542, 542, 542], 
[1033, 1024, 1192, 1193, 1193, 1193, 1193, 1193, 1193, 1194, 1024, 1024, 542, 542, 542, 542, 542, 542, 542, 542], 
[1033, 1024, 1200, 1201, 1201, 1201, 1201, 1201, 1201, 1202, 1024, 1024, 542, 542, 542, 542, 542, 542, 542, 542], 
[1033, 1024, 1200, 1201, 1201, 1201, 1201, 1201, 1201, 1202, 1024, 1024, 542, 542, 542, 542, 542, 542, 542, 542], 
[1033, 1024, 1200, 1201, 1201, 1201, 1201, 1201, 1201, 1202, 1024, 1024, 542, 542, 542, 542, 542, 542, 542, 542], 
[1033, 1024, 1208, 1209, 1209, 1209, 1209, 1209, 1209, 1210, 1024, 1024, 542, 542, 542, 542, 542, 542, 542, 542], 
[1033, 1024, 1024, 1024, 1024, 1024, 1024, 1024, 1024, 1024, 1024, 1024, 542, 542, 542, 542, 542, 542, 542, 542], 
[1033, 1024, 1024, 1024, 1024, 1024, 1024, 1024, 1024, 1024, 1024, 1024, 542, 542, 542, 542, 542, 542, 542, 542], 
[1033, 1024, 1024, 1024, 1024, 1024, 1024, 1024, 1024, 1024, 1024, 1024, 542, 542, 542, 542, 542, 542, 542, 542], 
[542, 542, 542, 542, 542, 542, 542, 542, 542, 542, 542, 542, 542, 542, 542, 542, 542, 542, 542, 542], 
[542, 542, 542, 542, 542, 542, 542, 542, 542, 542, 542, 542, 542, 542, 542, 542, 542, 542, 542, 542], 
[542, 542, 542, 542, 542, 542, 542, 542, 542, 542, 542, 542, 542, 542, 542, 542, 542, 542, 542, 542], 
[542, 542, 542, 542, 542, 542, 542, 542, 542, 542, 542, 542, 542, 542, 542, 542, 542, 542, 542, 542]], 

[[0, 0, 1474, 0, 1504, 1505, 1504, 1505, 0, 1474, 0, 0, 0, 0, 0, 0, 0, 0, 0, 0], 
[0, 0, 1482, 0, 1512, 1513, 1512, 1513, 0, 1482, 0, 0, 0, 0, 0, 0, 0, 0, 0, 0], 
[453, 0, 0, 0, 1520, 1521, 1520, 1521, 0, 0, 0, 455, 0, 0, 0, 0, 0, 0, 0, 0], 
[1770, 0, 0, 0, 0, 1660, 1661, 0, 0, 0, 0, 1770, 0, 0, 0, 0, 0, 0, 0, 0], 
[1778, 0, 0, 0, 0, 1668, 1669, 0, 0, 0, 0, 1778, 0, 0, 0, 0, 0, 0, 0, 0], 
[1756, 0, 0, 0, 1658, 2131, 2133, 1659, 0, 0, 0, 1756, 0, 0, 0, 0, 0, 0, 0, 0], 
[1764, 0, 0, 0, 1666, 2139, 2141, 1667, 0, 0, 0, 1764, 0, 0, 0, 0, 0, 0, 0, 0], 
[1756, 0, 0, 0, 0, 0, 0, 0, 0, 0, 0, 1756, 0, 0, 0, 0, 0, 0, 0, 0], 
[1764, 0, 0, 0, 0, 0, 0, 0, 0, 0, 0, 1764, 0, 0, 0, 0, 0, 0, 0, 0], 
[1770, 0, 0, 0, 0, 0, 0, 0, 0, 0, 0, 1770, 0, 0, 0, 0, 0, 0, 0, 0], 
[1778, 0, 0, 0, 1245, 1246, 1247, 0, 0, 0, 0, 1778, 0, 0, 0, 0, 0, 0, 0, 0], 
[0, 0, 0, 0, 1253, 1254, 1255, 0, 0, 0, 0, 0, 0, 0, 0, 0, 0, 0, 0, 0], 
[0, 0, 0, 0, 0, 0, 0, 0, 0, 0, 0, 0, 0, 0, 0, 0, 0, 0, 0, 0], 
[0, 0, 0, 0, 0, 0, 0, 0, 0, 0, 0, 0, 0, 0, 0, 0, 0, 0, 0, 0], 
[0, 0, 0, 0, 0, 0, 0, 0, 0, 0, 0, 0, 0, 0, 0, 0, 0, 0, 0, 0]], 

[[0, 0, 0, 0, 0, 0, 0, 0, 0, 0, 0, 0, 0, 0, 0, 0, 0, 0, 0, 0], 
[0, 0, 0, 0, 0, 0, 0, 0, 0, 0, 0, 0, 0, 0, 0, 0, 0, 0, 0, 0], 
[0, 0, 0, 0, 0, 0, 0, 0, 0, 0, 0, 0, 0, 0, 0, 0, 0, 0, 0, 0], 
[0, 0, 0, 0, 0, 0, 0, 0, 0, 0, 0, 0, 0, 0, 0, 0, 0, 0, 0, 0], 
[0, 0, 0, 0, 0, 0, 0, 0, 0, 0, 0, 0, 0, 0, 0, 0, 0, 0, 0, 0], 
[0, 0, 0, 0, 0, 0, 0, 0, 0, 0, 0, 0, 0, 0, 0, 0, 0, 0, 0, 0], 
[0, 0, 0, 0, 0, 0, 0, 0, 0, 0, 0, 0, 0, 0, 0, 0, 0, 0, 0, 0], 
[0, 0, 0, 0, 0, 0, 0, 0, 0, 0, 0, 0, 0, 0, 0, 0, 0, 0, 0, 0], 
[0, 0, 0, 0, 0, 0, 0, 0, 0, 0, 0, 0, 0, 0, 0, 0, 0, 0, 0, 0], 
[0, 0, 0, 0, 0, 0, 0, 0, 0, 0, 0, 0, 0, 0, 0, 0, 0, 0, 0, 0], 
[0, 0, 0, 0, 0, 0, 0, 0, 0, 0, 0, 0, 0, 0, 0, 0, 0, 0, 0, 0], 
[0, 0, 0, 0, 0, 0, 0, 0, 0, 0, 0, 0, 0, 0, 0, 0, 0, 0, 0, 0], 
[0, 0, 0, 0, 0, 0, 0, 0, 0, 0, 0, 0, 0, 0, 0, 0, 0, 0, 0, 0], 
[0, 0, 0, 0, 0, 0, 0, 0, 0, 0, 0, 0, 0, 0, 0, 0, 0, 0, 0, 0], 
[0, 0, 0, 0, 0, 0, 0, 0, 0, 0, 0, 0, 0, 0, 0, 0, 0, 0, 0, 0]]]
}
}
