{
	"Map": {
		"id": 69,
		"map_display_x": 0,
		"map_display_y": 0,
		"width": 46,
		"height": 35,
		"xsize": 46,
		"ysize": 35,
		"zsize": 3,
		"Name" : "Route 8",
		"Parent" : "",
		"Tileset" : "Outside",
		"BattleBack" : "",
		"Autoplay_bgm" : true,
		"BGM" : "route",
		"Autoplay_bgs" : false,
		"BGS" : "",
		"Encounter_list" : [],
		"Encounter_step" : 30,
		"table": [[[800, 801, 800, 801, 800, 801, 800, 801, 800, 801, 800, 801, 800, 801, 800, 801, 800, 801, 800, 803, 385, 1096, 1097, 1097, 1098, 386, 387, 388, 385, 390, 390, 385, 802, 801, 800, 801, 800, 801, 800, 801, 800, 801, 800, 801, 800, 801], 
[808, 809, 808, 809, 808, 809, 808, 809, 808, 809, 808, 809, 808, 809, 808, 809, 808, 809, 808, 811, 388, 1096, 1097, 1097, 1098, 388, 388, 389, 387, 390, 390, 386, 810, 809, 808, 809, 808, 809, 808, 809, 808, 809, 808, 809, 808, 809], 
[800, 801, 800, 801, 800, 801, 800, 801, 800, 801, 800, 801, 800, 801, 800, 801, 800, 801, 800, 803, 387, 1096, 1097, 1097, 1098, 385, 385, 388, 388, 390, 390, 385, 802, 801, 800, 801, 800, 801, 800, 801, 800, 801, 800, 801, 800, 801], 
[808, 809, 808, 809, 808, 809, 808, 809, 808, 809, 808, 809, 808, 809, 808, 809, 808, 809, 808, 811, 389, 1096, 1097, 1097, 1098, 387, 385, 385, 387, 390, 390, 388, 810, 809, 808, 809, 808, 809, 808, 809, 808, 809, 808, 809, 808, 809], 
[800, 801, 818, 819, 818, 819, 818, 819, 818, 819, 818, 819, 818, 819, 818, 819, 818, 819, 818, 819, 386, 1096, 1097, 1097, 1098, 385, 386, 385, 388, 390, 390, 386, 818, 819, 818, 819, 818, 819, 818, 819, 818, 819, 818, 819, 802, 801], 
[808, 809, 385, 385, 388, 385, 388, 385, 385, 385, 385, 385, 388, 385, 385, 385, 1192, 1188, 1188, 1188, 1188, 283, 273, 273, 285, 1188, 1188, 1161, 1162, 1188, 1188, 1193, 386, 386, 386, 386, 386, 386, 385, 385, 388, 386, 385, 386, 810, 809], 
[818, 819, 385, 1192, 1188, 1188, 1188, 1188, 1188, 1188, 1188, 1188, 1188, 1188, 1188, 1188, 1189, 1192, 1188, 1188, 1188, 322, 308, 308, 324, 1188, 1188, 1161, 1162, 1188, 1193, 1187, 1188, 1188, 1188, 1188, 1188, 1188, 1188, 1188, 1188, 1188, 1193, 388, 818, 819], 
[385, 385, 385, 1181, 1192, 1188, 1188, 1188, 1188, 1188, 1188, 1188, 1188, 1188, 1188, 1188, 1188, 1189, 1192, 1188, 1188, 304, 288, 288, 312, 1188, 1188, 1161, 1162, 1193, 1187, 1188, 1188, 1188, 1188, 1188, 1188, 1188, 1188, 1188, 1188, 1193, 1179, 385, 385, 388], 
[1188, 1188, 1188, 1189, 1181, 1177, 1192, 1188, 1188, 1188, 1188, 1188, 1188, 1188, 1188, 1188, 1188, 1188, 1189, 1192, 1188, 304, 288, 288, 312, 1188, 1193, 385, 386, 385, 1188, 1188, 1188, 1188, 1188, 1188, 1188, 1188, 1188, 1188, 1193, 1179, 1187, 1188, 1188, 1193], 
[1192, 1188, 1188, 1188, 1189, 1192, 1189, 1192, 1188, 1188, 1188, 1188, 1188, 1188, 1188, 1188, 1188, 1188, 1188, 1189, 1192, 328, 316, 316, 326, 1193, 1187, 1161, 1162, 1188, 1188, 1188, 1188, 1188, 1188, 1188, 1188, 1188, 1188, 1193, 1179, 1187, 1193, 1177, 1177, 1187], 
[1189, 1177, 1192, 1188, 1188, 1189, 1177, 1181, 1177, 1192, 1188, 1188, 1188, 1188, 1188, 1188, 1188, 1188, 1188, 1188, 1189, 379, 369, 369, 381, 1187, 385, 1161, 1162, 385, 385, 385, 385, 385, 385, 1188, 1188, 1188, 1193, 1179, 1179, 1177, 1187, 1188, 1193, 1177], 
[1188, 1188, 1189, 1177, 1177, 1177, 1192, 1189, 1192, 1189, 1177, 385, 385, 385, 385, 385, 385, 164, 164, 385, 385, 385, 385, 385, 385, 385, 387, 386, 385, 388, 385, 386, 385, 385, 388, 385, 385, 1177, 1179, 1179, 1187, 1188, 1193, 1177, 1187, 1193], 
[1177, 1192, 1188, 1188, 1188, 1188, 1189, 1177, 1181, 1177, 385, 385, 385, 385, 385, 385, 385, 184, 182, 385, 385, 385, 385, 385, 385, 385, 385, 385, 385, 386, 385, 388, 389, 387, 385, 385, 385, 385, 1179, 1187, 1188, 1193, 1187, 1188, 1193, 1187], 
[1188, 1189, 1177, 1192, 1188, 1188, 1188, 1188, 1189, 385, 385, 385, 385, 385, 385, 385, 385, 385, 385, 385, 385, 385, 385, 385, 385, 385, 385, 389, 386, 389, 388, 385, 387, 389, 385, 385, 385, 385, 1187, 1193, 1177, 1187, 1188, 1193, 1187, 1188], 
[1188, 1188, 1188, 1189, 1177, 385, 385, 164, 164, 385, 385, 385, 385, 385, 385, 385, 385, 385, 385, 385, 385, 385, 385, 385, 385, 385, 385, 385, 385, 385, 385, 385, 385, 385, 385, 385, 178, 168, 1177, 1187, 1188, 1188, 1193, 1187, 1193, 1177], 
[385, 385, 385, 385, 385, 385, 385, 184, 182, 385, 385, 385, 385, 385, 385, 385, 385, 385, 385, 385, 385, 385, 385, 385, 385, 385, 385, 385, 385, 385, 385, 385, 385, 385, 385, 385, 184, 182, 385, 385, 385, 1177, 1179, 1177, 1187, 1188], 
[385, 385, 385, 385, 385, 385, 385, 385, 385, 385, 385, 385, 385, 385, 385, 385, 385, 385, 385, 385, 385, 385, 385, 385, 385, 385, 385, 385, 48, 385, 385, 385, 385, 385, 48, 385, 385, 385, 385, 385, 385, 385, 1187, 1188, 1188, 1193], 
[385, 385, 385, 385, 385, 385, 385, 385, 385, 385, 385, 385, 385, 385, 385, 385, 385, 385, 385, 385, 385, 385, 385, 385, 385, 385, 385, 385, 48, 385, 385, 385, 385, 385, 48, 385, 385, 385, 385, 385, 385, 385, 385, 385, 1177, 1187], 
[385, 385, 385, 385, 385, 385, 385, 385, 385, 385, 385, 385, 385, 385, 385, 385, 385, 385, 385, 385, 385, 385, 385, 385, 385, 385, 385, 385, 48, 385, 385, 385, 385, 385, 48, 385, 385, 385, 385, 385, 385, 385, 385, 385, 385, 385], 
[385, 385, 385, 385, 385, 385, 385, 385, 385, 385, 385, 385, 385, 385, 385, 385, 385, 385, 385, 385, 385, 385, 385, 385, 385, 385, 385, 385, 48, 385, 385, 385, 385, 385, 48, 385, 385, 385, 385, 385, 385, 385, 385, 385, 385, 385], 
[385, 385, 385, 385, 385, 385, 385, 385, 385, 385, 385, 385, 385, 385, 385, 385, 385, 385, 385, 385, 385, 385, 385, 385, 385, 385, 385, 385, 48, 385, 385, 385, 385, 385, 48, 385, 385, 385, 385, 385, 385, 385, 385, 385, 385, 385], 
[385, 385, 385, 385, 385, 385, 385, 385, 385, 385, 385, 385, 385, 385, 385, 385, 385, 385, 385, 385, 385, 385, 385, 385, 385, 385, 385, 385, 385, 385, 385, 385, 385, 385, 385, 385, 385, 385, 385, 385, 385, 385, 385, 385, 385, 385], 
[385, 385, 385, 385, 385, 385, 385, 385, 385, 385, 385, 385, 385, 385, 385, 385, 385, 385, 385, 385, 385, 385, 385, 385, 385, 385, 385, 385, 385, 385, 385, 385, 385, 385, 385, 385, 385, 385, 385, 385, 385, 385, 385, 385, 385, 385], 
[385, 385, 385, 385, 385, 385, 385, 385, 385, 385, 385, 385, 385, 385, 385, 385, 385, 385, 385, 385, 385, 385, 385, 385, 385, 385, 385, 385, 385, 385, 385, 385, 385, 385, 385, 385, 385, 385, 385, 385, 385, 385, 385, 385, 385, 385], 
[385, 385, 385, 385, 385, 385, 385, 385, 385, 385, 385, 385, 385, 385, 385, 385, 385, 385, 385, 385, 385, 385, 385, 385, 385, 385, 385, 385, 385, 385, 385, 385, 385, 385, 385, 385, 385, 385, 385, 385, 385, 385, 385, 385, 385, 385], 
[385, 385, 385, 385, 385, 385, 385, 385, 385, 385, 385, 385, 385, 385, 385, 385, 385, 385, 385, 385, 385, 385, 385, 385, 385, 385, 385, 385, 385, 385, 385, 385, 385, 385, 385, 385, 385, 385, 385, 385, 385, 385, 385, 385, 385, 385], 
[385, 385, 385, 385, 385, 385, 385, 385, 385, 385, 385, 385, 385, 385, 385, 385, 385, 385, 385, 385, 385, 385, 385, 385, 385, 385, 385, 385, 385, 385, 385, 385, 385, 385, 385, 385, 385, 385, 385, 385, 385, 385, 385, 385, 385, 385], 
[385, 385, 385, 385, 385, 385, 385, 385, 385, 385, 385, 385, 385, 385, 385, 385, 385, 385, 385, 385, 385, 385, 385, 385, 385, 385, 385, 385, 385, 385, 385, 385, 385, 385, 385, 385, 385, 385, 385, 385, 385, 385, 385, 385, 385, 385], 
[385, 385, 385, 385, 385, 385, 385, 385, 385, 385, 385, 385, 385, 385, 385, 385, 385, 385, 385, 385, 385, 385, 385, 385, 385, 385, 385, 385, 385, 385, 385, 385, 385, 385, 385, 385, 385, 385, 385, 385, 385, 385, 385, 385, 385, 385], 
[385, 385, 385, 385, 385, 385, 385, 385, 385, 385, 385, 385, 385, 385, 385, 385, 385, 385, 385, 385, 385, 385, 385, 385, 385, 385, 385, 385, 385, 385, 385, 385, 385, 385, 385, 385, 385, 385, 385, 385, 385, 385, 385, 385, 385, 385], 
[385, 385, 385, 385, 385, 385, 385, 385, 385, 385, 385, 385, 385, 385, 385, 385, 385, 385, 385, 385, 385, 385, 385, 385, 385, 385, 385, 385, 385, 385, 385, 385, 385, 385, 385, 385, 385, 385, 385, 385, 385, 385, 385, 385, 385, 385], 
[385, 385, 385, 385, 385, 385, 385, 385, 385, 385, 385, 385, 385, 385, 385, 385, 385, 385, 385, 385, 385, 385, 385, 385, 385, 385, 385, 385, 385, 385, 385, 385, 385, 385, 385, 385, 385, 385, 385, 385, 385, 385, 385, 385, 385, 385], 
[385, 385, 385, 385, 385, 385, 385, 385, 385, 385, 385, 385, 385, 385, 385, 385, 385, 385, 385, 385, 385, 385, 385, 385, 385, 385, 385, 385, 385, 385, 385, 385, 385, 385, 385, 385, 385, 385, 385, 385, 385, 385, 385, 385, 385, 385], 
[385, 385, 385, 385, 385, 385, 385, 385, 385, 385, 385, 385, 385, 385, 385, 385, 385, 385, 385, 385, 385, 385, 385, 385, 385, 385, 385, 385, 385, 385, 385, 385, 385, 385, 385, 385, 385, 385, 385, 385, 385, 385, 385, 385, 385, 385], 
[385, 385, 385, 385, 385, 385, 385, 385, 385, 385, 385, 385, 385, 385, 385, 385, 385, 385, 385, 385, 385, 385, 385, 385, 385, 385, 385, 385, 385, 385, 385, 385, 385, 385, 385, 385, 385, 385, 385, 385, 385, 385, 385, 385, 385, 385]], 

[[0, 0, 0, 0, 0, 0, 0, 0, 0, 0, 0, 0, 0, 0, 0, 0, 0, 0, 0, 0, 1664, 1136, 0, 0, 1138, 0, 0, 0, 0, 0, 0, 1665, 0, 0, 0, 0, 0, 0, 0, 0, 0, 0, 0, 0, 0, 0], 
[0, 0, 0, 0, 0, 0, 0, 0, 0, 0, 0, 0, 0, 0, 0, 0, 0, 0, 0, 0, 1664, 1136, 0, 0, 1138, 0, 0, 0, 0, 0, 0, 1665, 0, 0, 0, 0, 0, 0, 0, 0, 0, 0, 0, 0, 0, 0], 
[0, 0, 0, 0, 0, 0, 0, 0, 0, 0, 0, 0, 0, 0, 0, 0, 0, 0, 0, 0, 1664, 1136, 0, 0, 1138, 0, 0, 0, 0, 0, 0, 1665, 0, 0, 0, 0, 0, 0, 0, 0, 0, 0, 0, 0, 0, 0], 
[0, 0, 0, 0, 0, 0, 0, 0, 0, 0, 0, 0, 0, 0, 0, 0, 0, 0, 0, 0, 1664, 1136, 0, 0, 1138, 0, 0, 0, 0, 0, 0, 1665, 0, 0, 0, 0, 0, 0, 0, 0, 0, 0, 0, 0, 0, 0], 
[0, 0, 0, 0, 0, 0, 0, 0, 0, 0, 0, 0, 0, 0, 0, 0, 0, 0, 0, 0, 1705, 1136, 0, 0, 1138, 1680, 1682, 0, 0, 1680, 1681, 1677, 0, 0, 0, 0, 0, 0, 0, 0, 0, 0, 0, 0, 0, 0], 
[0, 0, 1658, 1681, 1681, 1681, 1681, 1681, 1681, 1681, 1681, 1681, 1681, 1681, 1681, 1682, 0, 0, 0, 0, 0, 1144, 0, 0, 1146, 0, 0, 0, 0, 0, 0, 0, 1680, 1681, 1681, 1681, 1681, 1681, 1681, 1681, 1681, 1681, 1681, 1661, 0, 0], 
[0, 0, 1664, 0, 0, 0, 0, 0, 0, 0, 0, 0, 0, 0, 0, 0, 0, 0, 0, 0, 0, 0, 0, 0, 0, 0, 0, 0, 0, 0, 0, 0, 0, 0, 0, 0, 0, 0, 0, 0, 0, 0, 0, 1665, 0, 0], 
[1681, 1681, 1679, 0, 0, 0, 0, 0, 0, 0, 0, 0, 0, 0, 0, 0, 0, 0, 0, 0, 0, 0, 0, 0, 0, 0, 0, 0, 0, 0, 0, 0, 0, 0, 0, 0, 0, 0, 0, 0, 0, 0, 0, 1678, 1681, 1681], 
[0, 0, 0, 0, 0, 0, 0, 0, 0, 0, 0, 0, 0, 0, 0, 0, 0, 0, 0, 0, 0, 0, 0, 0, 0, 0, 0, 0, 0, 1184, 0, 0, 0, 0, 0, 0, 0, 0, 0, 0, 0, 0, 0, 0, 0, 0], 
[0, 0, 0, 0, 0, 0, 0, 0, 0, 0, 0, 0, 0, 0, 0, 0, 0, 0, 0, 0, 0, 0, 0, 0, 0, 0, 0, 0, 0, 0, 0, 0, 0, 0, 0, 0, 0, 0, 0, 0, 0, 0, 0, 0, 0, 0], 
[0, 0, 0, 0, 0, 0, 0, 0, 0, 0, 0, 0, 0, 0, 0, 0, 0, 0, 0, 0, 0, 0, 0, 0, 0, 0, 1185, 0, 0, 1185, 1185, 1185, 1185, 1185, 1185, 0, 0, 0, 0, 0, 0, 0, 0, 0, 0, 0], 
[0, 0, 0, 0, 0, 0, 0, 0, 0, 0, 82, 68, 68, 68, 68, 68, 68, 1129, 1129, 68, 68, 49, 48, 48, 50, 84, 0, 0, 0, 0, 0, 0, 0, 0, 0, 82, 68, 84, 0, 0, 0, 0, 0, 0, 0, 0], 
[0, 0, 0, 0, 0, 0, 0, 0, 0, 82, 49, 178, 164, 180, 48, 48, 48, 0, 0, 48, 48, 48, 48, 48, 48, 72, 0, 0, 0, 0, 0, 0, 0, 0, 0, 64, 48, 72, 0, 0, 0, 0, 0, 0, 0, 0], 
[0, 0, 0, 0, 0, 0, 0, 0, 0, 64, 178, 145, 144, 146, 180, 48, 178, 180, 48, 48, 48, 48, 48, 48, 48, 50, 84, 0, 0, 0, 0, 0, 0, 0, 82, 49, 48, 72, 0, 0, 0, 0, 0, 0, 0, 0], 
[0, 0, 0, 0, 82, 68, 68, 1129, 1129, 49, 160, 144, 144, 144, 168, 48, 184, 182, 48, 48, 48, 48, 48, 48, 48, 48, 50, 69, 68, 68, 1589, 1590, 1591, 68, 49, 48, 0, 1146, 84, 0, 0, 0, 0, 0, 0, 0], 
[68, 68, 68, 68, 49, 48, 48, 0, 0, 48, 184, 152, 144, 148, 182, 48, 178, 180, 48, 48, 48, 48, 48, 48, 48, 48, 48, 48, 48, 48, 1597, 1598, 1599, 48, 48, 48, 0, 0, 50, 68, 68, 84, 0, 0, 0, 0], 
[48, 48, 48, 48, 48, 48, 48, 178, 180, 48, 48, 184, 172, 182, 48, 48, 184, 182, 48, 48, 48, 48, 48, 48, 48, 48, 48, 48, 4216, 1524, 1597, 1598, 1599, 1524, 4217, 178, 180, 48, 48, 48, 48, 72, 0, 0, 0, 0], 
[48, 48, 48, 48, 48, 48, 48, 184, 182, 178, 180, 48, 48, 48, 48, 178, 180, 48, 48, 48, 48, 48, 48, 48, 48, 48, 48, 48, 4232, 48, 48, 48, 48, 48, 4233, 184, 182, 48, 48, 48, 48, 50, 68, 68, 84, 0], 
[48, 48, 48, 48, 48, 48, 48, 178, 180, 184, 182, 178, 180, 178, 180, 184, 182, 48, 48, 48, 48, 48, 48, 48, 48, 48, 48, 48, 4224, 48, 48, 48, 48, 48, 4225, 48, 48, 48, 48, 48, 48, 48, 48, 48, 50, 68], 
[164, 164, 180, 48, 48, 48, 48, 184, 182, 48, 48, 184, 182, 184, 182, 48, 48, 48, 48, 48, 48, 48, 48, 48, 48, 48, 48, 48, 4232, 48, 48, 48, 48, 48, 4233, 48, 48, 48, 48, 48, 48, 48, 48, 48, 48, 48], 
[144, 144, 146, 180, 48, 48, 178, 180, 178, 180, 48, 48, 48, 48, 48, 48, 48, 48, 48, 48, 48, 48, 48, 48, 48, 48, 48, 48, 4240, 48, 48, 48, 48, 48, 4241, 178, 180, 48, 48, 48, 48, 178, 180, 48, 48, 48], 
[144, 144, 144, 168, 48, 48, 184, 182, 184, 182, 48, 178, 164, 164, 180, 48, 48, 48, 48, 48, 48, 48, 48, 48, 48, 48, 48, 178, 180, 48, 48, 48, 48, 48, 48, 184, 182, 178, 180, 48, 48, 160, 146, 164, 180, 48], 
[144, 144, 144, 168, 48, 48, 48, 48, 178, 180, 48, 160, 144, 144, 146, 164, 180, 48, 48, 48, 48, 48, 48, 48, 48, 48, 48, 184, 182, 48, 48, 48, 48, 48, 48, 48, 48, 184, 182, 48, 48, 184, 172, 152, 146, 164], 
[144, 144, 144, 168, 48, 48, 48, 48, 184, 182, 48, 184, 152, 144, 144, 144, 146, 164, 164, 164, 180, 48, 48, 48, 48, 48, 178, 180, 48, 48, 48, 48, 48, 48, 48, 48, 48, 48, 178, 180, 48, 48, 48, 184, 152, 144], 
[144, 144, 144, 168, 48, 48, 48, 48, 48, 178, 180, 48, 184, 152, 144, 144, 144, 144, 144, 144, 146, 164, 164, 164, 180, 48, 184, 182, 48, 48, 48, 178, 164, 164, 180, 48, 48, 48, 184, 182, 178, 180, 48, 48, 184, 152], 
[144, 144, 144, 146, 180, 48, 48, 48, 48, 184, 182, 48, 48, 184, 172, 172, 152, 144, 144, 144, 144, 144, 144, 148, 182, 48, 48, 178, 180, 48, 48, 160, 144, 144, 146, 180, 48, 48, 48, 48, 184, 182, 48, 48, 48, 160], 
[144, 144, 144, 144, 168, 48, 48, 48, 178, 180, 178, 180, 48, 48, 48, 48, 184, 172, 172, 172, 172, 172, 172, 182, 48, 178, 180, 184, 182, 48, 48, 184, 152, 144, 144, 146, 164, 180, 48, 48, 48, 48, 48, 48, 48, 160], 
[144, 144, 144, 144, 146, 180, 48, 48, 184, 182, 184, 182, 178, 180, 178, 180, 48, 48, 48, 48, 48, 48, 48, 48, 48, 184, 182, 48, 178, 180, 48, 48, 184, 152, 144, 144, 144, 146, 164, 180, 48, 48, 48, 48, 178, 145], 
[144, 144, 144, 144, 144, 146, 180, 48, 48, 48, 48, 48, 184, 182, 184, 182, 178, 180, 178, 180, 178, 180, 48, 48, 178, 180, 48, 48, 184, 182, 48, 48, 48, 184, 172, 152, 144, 144, 144, 146, 164, 164, 164, 164, 145, 144], 
[144, 144, 144, 144, 144, 144, 168, 48, 48, 48, 48, 48, 48, 48, 178, 180, 184, 182, 184, 182, 184, 182, 178, 180, 184, 182, 48, 48, 48, 178, 180, 48, 48, 48, 48, 184, 152, 144, 144, 144, 144, 144, 144, 144, 144, 144], 
[144, 144, 144, 144, 144, 144, 146, 180, 48, 48, 48, 48, 48, 48, 184, 182, 48, 48, 48, 178, 180, 48, 184, 182, 48, 48, 48, 48, 48, 184, 182, 178, 180, 178, 180, 48, 160, 144, 144, 144, 144, 144, 144, 144, 144, 144], 
[144, 144, 144, 144, 144, 144, 144, 146, 164, 180, 48, 48, 48, 48, 48, 48, 48, 48, 48, 184, 182, 48, 48, 48, 48, 48, 48, 48, 48, 48, 48, 184, 182, 184, 182, 48, 184, 152, 144, 144, 144, 144, 144, 144, 144, 144], 
[144, 144, 144, 144, 144, 144, 144, 144, 144, 146, 164, 164, 180, 48, 48, 48, 48, 48, 48, 48, 48, 48, 48, 48, 48, 48, 178, 180, 48, 48, 48, 48, 48, 178, 180, 48, 48, 160, 144, 144, 144, 144, 144, 144, 144, 144], 
[144, 144, 144, 144, 144, 144, 144, 144, 144, 144, 144, 144, 146, 164, 164, 164, 180, 48, 48, 48, 48, 48, 48, 48, 48, 178, 145, 146, 180, 48, 48, 48, 48, 184, 182, 48, 48, 160, 144, 144, 144, 144, 144, 144, 144, 144], 
[172, 172, 172, 172, 172, 172, 172, 172, 172, 172, 172, 172, 172, 172, 172, 172, 174, 177, 177, 177, 177, 177, 177, 177, 177, 173, 172, 172, 174, 189, 76, 76, 76, 76, 76, 76, 76, 184, 172, 172, 172, 172, 172, 172, 172, 172]], 

[[0, 0, 0, 0, 0, 0, 0, 0, 0, 0, 0, 0, 0, 0, 0, 0, 0, 0, 0, 0, 0, 0, 0, 0, 0, 0, 0, 0, 0, 0, 0, 0, 0, 0, 0, 0, 0, 0, 0, 0, 0, 0, 0, 0, 0, 0], 
[0, 0, 0, 0, 0, 0, 0, 0, 0, 0, 0, 0, 0, 0, 0, 0, 0, 0, 0, 0, 0, 0, 0, 0, 0, 0, 0, 0, 0, 0, 0, 0, 0, 0, 0, 0, 0, 0, 0, 0, 0, 0, 0, 0, 0, 0], 
[0, 0, 0, 0, 0, 0, 0, 0, 0, 0, 0, 0, 0, 0, 0, 0, 0, 0, 0, 0, 0, 0, 0, 0, 0, 0, 0, 0, 0, 0, 0, 0, 0, 0, 0, 0, 0, 0, 0, 0, 0, 0, 0, 0, 0, 0], 
[0, 0, 0, 0, 0, 0, 0, 0, 0, 0, 0, 0, 0, 0, 0, 0, 0, 0, 0, 0, 0, 0, 0, 0, 0, 0, 0, 0, 0, 0, 0, 0, 0, 0, 0, 0, 0, 0, 0, 0, 0, 0, 0, 0, 0, 0], 
[0, 0, 0, 0, 0, 0, 0, 0, 0, 0, 0, 0, 0, 0, 0, 0, 0, 0, 0, 0, 0, 0, 0, 0, 0, 0, 0, 0, 0, 0, 0, 0, 0, 0, 0, 0, 0, 0, 0, 0, 0, 0, 0, 0, 0, 0], 
[0, 0, 0, 0, 0, 0, 0, 0, 0, 0, 0, 0, 0, 0, 0, 0, 0, 0, 0, 0, 0, 0, 0, 0, 0, 0, 0, 0, 0, 0, 0, 0, 0, 0, 0, 0, 0, 0, 0, 0, 0, 0, 0, 0, 0, 0], 
[0, 0, 0, 0, 0, 0, 0, 0, 0, 0, 0, 0, 0, 0, 0, 0, 0, 0, 0, 0, 0, 0, 0, 0, 0, 0, 0, 0, 0, 0, 0, 0, 0, 0, 0, 0, 0, 0, 0, 0, 0, 0, 0, 0, 0, 0], 
[0, 0, 0, 0, 0, 0, 0, 0, 0, 0, 0, 0, 0, 0, 0, 0, 0, 0, 0, 0, 0, 0, 0, 0, 0, 0, 0, 0, 0, 0, 0, 0, 0, 0, 0, 0, 0, 0, 0, 0, 0, 0, 0, 0, 0, 0], 
[0, 0, 0, 0, 0, 0, 0, 0, 0, 0, 0, 0, 0, 0, 0, 0, 0, 0, 0, 0, 0, 0, 0, 0, 0, 0, 0, 0, 0, 0, 0, 0, 0, 0, 0, 0, 0, 0, 0, 0, 0, 0, 0, 0, 0, 0], 
[0, 0, 0, 0, 0, 0, 0, 0, 0, 0, 0, 0, 0, 0, 0, 0, 0, 0, 0, 0, 0, 0, 0, 0, 0, 0, 0, 0, 0, 0, 0, 0, 0, 0, 0, 0, 0, 0, 0, 0, 0, 0, 0, 0, 0, 0], 
[0, 0, 0, 0, 0, 0, 0, 0, 0, 0, 0, 0, 0, 0, 0, 0, 0, 0, 0, 0, 0, 0, 0, 0, 0, 0, 0, 0, 0, 0, 0, 0, 0, 0, 0, 0, 0, 0, 0, 0, 0, 0, 0, 0, 0, 0], 
[0, 0, 0, 0, 0, 0, 0, 0, 0, 0, 0, 0, 0, 0, 0, 0, 0, 1506, 1507, 0, 0, 0, 0, 0, 0, 0, 0, 0, 0, 0, 0, 0, 0, 0, 0, 0, 0, 0, 0, 0, 0, 0, 0, 0, 0, 0], 
[0, 0, 0, 0, 0, 0, 0, 0, 0, 0, 0, 0, 0, 0, 0, 0, 0, 1514, 1515, 0, 0, 0, 0, 0, 0, 0, 0, 0, 0, 0, 0, 0, 0, 0, 0, 0, 0, 0, 0, 0, 0, 0, 0, 0, 0, 0], 
[0, 0, 0, 0, 0, 0, 0, 0, 0, 0, 0, 0, 0, 0, 0, 0, 1506, 1507, 0, 0, 0, 0, 0, 0, 0, 0, 0, 0, 0, 0, 0, 0, 0, 0, 0, 0, 0, 0, 0, 0, 0, 0, 0, 0, 0, 0], 
[0, 0, 0, 0, 0, 0, 0, 1506, 1507, 0, 0, 0, 0, 0, 0, 0, 1514, 1515, 0, 0, 0, 0, 0, 0, 0, 0, 0, 0, 0, 0, 0, 0, 0, 0, 0, 0, 1506, 1507, 0, 0, 0, 0, 0, 0, 0, 0], 
[0, 0, 0, 0, 0, 0, 0, 1514, 1515, 0, 0, 0, 0, 0, 0, 0, 1506, 1507, 0, 0, 0, 0, 0, 0, 0, 0, 0, 0, 0, 0, 3355, 3356, 3357, 0, 0, 0, 1514, 1515, 0, 0, 0, 0, 0, 0, 0, 0], 
[0, 0, 0, 0, 0, 0, 0, 1506, 1507, 0, 0, 0, 0, 0, 0, 0, 1514, 1515, 0, 0, 0, 0, 0, 0, 0, 0, 0, 0, 4216, 3688, 3689, 3690, 3691, 3692, 4217, 1506, 1507, 0, 0, 0, 0, 0, 0, 0, 0, 0], 
[0, 0, 0, 0, 0, 0, 0, 1514, 1515, 1506, 1507, 0, 0, 0, 0, 1506, 1507, 0, 0, 0, 0, 0, 0, 0, 0, 0, 0, 0, 0, 3696, 3697, 3698, 3699, 3700, 0, 1514, 1515, 0, 0, 0, 0, 0, 0, 0, 0, 0], 
[0, 0, 0, 0, 0, 0, 0, 1506, 1507, 1514, 1515, 1506, 1507, 1506, 1507, 1514, 1515, 0, 0, 0, 0, 0, 0, 0, 0, 0, 0, 0, 4216, 3704, 3705, 3706, 3707, 3708, 4217, 0, 0, 0, 0, 0, 0, 0, 0, 0, 0, 0], 
[0, 0, 0, 0, 0, 0, 0, 1514, 1515, 0, 0, 1514, 1515, 1514, 1515, 0, 0, 0, 0, 0, 0, 0, 0, 0, 0, 0, 0, 0, 0, 3712, 3713, 3714, 3715, 3716, 0, 0, 0, 0, 0, 0, 0, 0, 0, 0, 0, 0], 
[0, 0, 0, 0, 0, 0, 1506, 1507, 1506, 1507, 0, 0, 0, 0, 0, 0, 0, 0, 0, 0, 0, 0, 0, 0, 0, 0, 0, 0, 0, 3720, 3721, 3722, 3723, 3724, 0, 1506, 1507, 0, 0, 0, 0, 0, 0, 0, 0, 0], 
[0, 0, 0, 0, 0, 0, 1514, 1515, 1514, 1515, 0, 0, 0, 0, 0, 0, 0, 0, 0, 0, 0, 0, 0, 0, 0, 0, 0, 1506, 1507, 0, 0, 0, 0, 0, 0, 1514, 1515, 1506, 1507, 0, 0, 0, 0, 0, 0, 0], 
[0, 0, 0, 0, 0, 0, 0, 0, 1506, 1507, 0, 0, 0, 0, 0, 0, 0, 0, 0, 0, 0, 0, 0, 0, 0, 0, 0, 1514, 1515, 0, 0, 0, 0, 0, 0, 0, 0, 1514, 1515, 0, 0, 0, 0, 0, 0, 0], 
[0, 0, 0, 0, 0, 0, 0, 0, 1514, 1515, 0, 0, 0, 0, 0, 0, 0, 0, 0, 0, 0, 0, 0, 0, 0, 0, 1506, 1507, 0, 0, 0, 0, 0, 0, 0, 0, 0, 0, 1506, 1507, 0, 0, 0, 0, 0, 0], 
[0, 0, 0, 0, 0, 0, 0, 0, 0, 1506, 1507, 0, 0, 0, 0, 0, 0, 0, 0, 0, 0, 0, 0, 0, 0, 0, 1514, 1515, 0, 0, 0, 0, 0, 0, 0, 0, 0, 0, 1514, 1515, 1506, 1507, 0, 0, 0, 0], 
[0, 0, 0, 0, 0, 0, 0, 0, 0, 1514, 1515, 0, 0, 0, 0, 0, 0, 0, 0, 0, 0, 0, 0, 0, 0, 0, 0, 1506, 1507, 0, 0, 0, 0, 0, 0, 0, 0, 0, 0, 0, 1514, 1515, 0, 0, 0, 0], 
[0, 0, 0, 0, 0, 0, 0, 0, 1506, 1507, 1506, 1507, 0, 0, 0, 0, 0, 0, 0, 0, 0, 0, 0, 0, 0, 1506, 1507, 1514, 1515, 0, 0, 0, 0, 0, 0, 0, 0, 0, 0, 0, 0, 0, 0, 0, 0, 0], 
[0, 0, 0, 0, 0, 0, 0, 0, 1514, 1515, 1514, 1515, 1506, 1507, 1506, 1507, 0, 0, 0, 0, 0, 0, 0, 0, 0, 1514, 1515, 0, 1506, 1507, 0, 0, 0, 0, 0, 0, 0, 0, 0, 0, 0, 0, 0, 0, 0, 0], 
[0, 0, 0, 0, 0, 0, 0, 0, 0, 0, 0, 0, 1514, 1515, 1514, 1515, 1506, 1507, 1506, 1507, 1506, 1507, 0, 0, 1506, 1507, 0, 0, 1514, 1515, 0, 0, 0, 0, 0, 0, 0, 0, 0, 0, 0, 0, 0, 0, 0, 0], 
[0, 0, 0, 0, 0, 0, 0, 0, 0, 0, 0, 0, 0, 0, 1506, 1507, 1514, 1515, 1514, 1515, 1514, 1515, 1506, 1507, 1514, 1515, 0, 0, 0, 1506, 1507, 0, 0, 0, 0, 0, 0, 0, 0, 0, 0, 0, 0, 0, 0, 0], 
[0, 0, 0, 0, 0, 0, 0, 0, 0, 0, 0, 0, 0, 0, 1514, 1515, 0, 0, 0, 1506, 1507, 0, 1514, 1515, 0, 0, 0, 0, 0, 1514, 1515, 1506, 1507, 1506, 1507, 0, 0, 0, 0, 0, 0, 0, 0, 0, 0, 0], 
[0, 0, 0, 0, 0, 0, 0, 0, 0, 0, 0, 0, 0, 0, 0, 0, 0, 0, 0, 1514, 1515, 0, 0, 0, 0, 0, 0, 0, 0, 0, 0, 1514, 1515, 1514, 1515, 0, 0, 0, 0, 0, 0, 0, 0, 0, 0, 0], 
[0, 0, 0, 0, 0, 0, 0, 0, 0, 0, 0, 0, 0, 0, 0, 0, 0, 0, 0, 0, 0, 0, 0, 0, 0, 0, 0, 0, 0, 0, 0, 0, 0, 1506, 1507, 0, 0, 0, 0, 0, 0, 0, 0, 0, 0, 0], 
[0, 0, 0, 0, 0, 0, 0, 0, 0, 0, 0, 0, 0, 0, 0, 0, 0, 0, 0, 0, 0, 0, 0, 0, 0, 0, 0, 0, 0, 0, 0, 0, 0, 1514, 1515, 0, 0, 0, 0, 0, 0, 0, 0, 0, 0, 0], 
[0, 0, 0, 0, 0, 0, 0, 0, 0, 0, 0, 0, 0, 0, 0, 0, 0, 0, 0, 0, 0, 0, 0, 0, 0, 0, 0, 0, 0, 0, 0, 0, 0, 0, 0, 0, 0, 0, 0, 0, 0, 0, 0, 0, 0, 0]]]
}
}
