{
	"Map": {
		"id": 3,
		"map_display_x": 0,
		"map_display_y": 0,
		"width": 31,
		"height": 15,
		"xsize": 31,
		"ysize": 15,
		"zsize": 3,
		"Name" : "\PN's house",
		"Parent" : "Lappet Town",
		"Tileset" : "Interior general",
		"BattleBack" : "",
		"Autoplay_bgm" : true,
		"BGM" : "Mom Theme",
		"Autoplay_bgs" : false,
		"BGS" : "",
		"Encounter_list" : [],
		"Encounter_step" : 30,
		"table": [[[416, 416, 416, 416, 416, 416, 416, 416, 416, 416, 416, 416, 542, 542, 542, 542, 542, 542, 542, 542, 416, 416, 416, 416, 416, 416, 416, 416, 416, 416, 416], 
[424, 424, 424, 424, 424, 424, 424, 424, 424, 424, 424, 424, 542, 542, 542, 542, 542, 542, 542, 542, 424, 424, 424, 424, 424, 424, 424, 424, 424, 424, 424], 
[769, 769, 769, 769, 769, 769, 769, 769, 769, 769, 769, 769, 542, 542, 542, 542, 542, 542, 542, 542, 769, 769, 769, 769, 769, 769, 769, 769, 769, 769, 769], 
[769, 760, 760, 760, 760, 760, 760, 760, 760, 760, 769, 769, 542, 542, 542, 542, 542, 542, 542, 542, 769, 760, 760, 760, 760, 760, 760, 769, 769, 770, 760], 
[769, 760, 760, 760, 760, 760, 760, 760, 760, 760, 760, 760, 542, 542, 542, 542, 542, 542, 542, 542, 769, 760, 760, 760, 760, 760, 760, 760, 760, 760, 760], 
[769, 760, 760, 760, 760, 760, 760, 760, 760, 760, 760, 760, 542, 542, 542, 542, 542, 542, 542, 542, 769, 760, 760, 760, 1177, 1177, 1177, 760, 760, 760, 760], 
[769, 760, 760, 760, 760, 760, 760, 760, 760, 760, 760, 760, 542, 542, 542, 542, 542, 542, 542, 542, 769, 760, 760, 760, 1177, 1177, 1177, 760, 760, 760, 760], 
[769, 760, 760, 760, 760, 760, 760, 760, 760, 760, 760, 760, 542, 542, 542, 542, 542, 542, 542, 542, 769, 760, 760, 760, 760, 760, 760, 760, 760, 760, 760], 
[769, 760, 760, 760, 760, 760, 760, 760, 760, 760, 760, 760, 542, 542, 542, 542, 542, 542, 542, 542, 769, 760, 760, 760, 760, 760, 760, 760, 760, 760, 760], 
[542, 542, 542, 542, 542, 542, 542, 542, 542, 542, 542, 542, 542, 542, 542, 542, 542, 542, 542, 542, 542, 542, 542, 542, 542, 542, 542, 542, 542, 542, 542], 
[542, 542, 542, 542, 542, 542, 542, 542, 542, 542, 542, 542, 542, 542, 542, 542, 542, 542, 542, 542, 542, 542, 542, 542, 542, 542, 542, 542, 542, 542, 542], 
[542, 542, 542, 542, 542, 542, 542, 542, 542, 542, 542, 542, 542, 542, 542, 542, 542, 542, 542, 542, 542, 542, 542, 542, 542, 542, 542, 542, 542, 542, 542], 
[542, 542, 542, 542, 542, 542, 542, 542, 542, 542, 542, 542, 542, 542, 542, 542, 542, 542, 542, 542, 542, 542, 542, 542, 542, 542, 542, 542, 542, 542, 542], 
[542, 542, 542, 542, 542, 542, 542, 542, 542, 542, 542, 542, 542, 542, 542, 542, 542, 542, 542, 542, 542, 542, 542, 542, 542, 542, 542, 542, 542, 542, 542], 
[542, 542, 542, 542, 542, 542, 542, 542, 542, 542, 542, 542, 542, 542, 542, 542, 542, 542, 542, 542, 542, 542, 542, 542, 542, 542, 542, 542, 542, 542, 542]], 

[[0, 0, 1530, 1531, 0, 1712, 1491, 1492, 0, 0, 0, 0, 0, 0, 0, 0, 0, 0, 0, 0, 0, 0, 0, 1504, 1505, 1457, 0, 0, 0, 1457, 1457], 
[1569, 1570, 1538, 1539, 0, 1720, 1499, 1500, 0, 0, 1256, 1257, 0, 0, 0, 0, 0, 0, 0, 0, 1904, 1906, 1556, 1512, 1513, 1465, 0, 1262, 0, 1465, 1465], 
[1577, 1578, 1546, 1547, 0, 1728, 0, 0, 0, 1287, 1264, 1265, 0, 0, 0, 0, 0, 0, 0, 0, 1936, 1938, 1564, 1520, 1521, 0, 0, 1270, 1271, 1287, 0], 
[0, 0, 0, 1168, 1169, 1169, 1169, 1169, 1170, 1295, 1272, 1273, 0, 0, 0, 0, 0, 0, 0, 0, 0, 0, 0, 0, 0, 0, 0, 1278, 1279, 1295, 0], 
[0, 0, 0, 1176, 1177, 1177, 1177, 1177, 1178, 0, 0, 0, 0, 0, 0, 0, 0, 0, 0, 0, 1584, 1585, 1586, 1168, 1169, 1169, 1169, 1170, 0, 0, 0], 
[0, 0, 0, 1176, 1177, 1177, 1177, 1177, 1178, 0, 0, 0, 0, 0, 0, 0, 0, 0, 0, 0, 1592, 1593, 1594, 1176, 0, 1728, 0, 1178, 0, 0, 0], 
[1770, 0, 0, 1184, 1185, 1185, 1185, 1185, 1186, 0, 0, 1770, 0, 0, 0, 0, 0, 0, 0, 0, 1600, 1601, 1602, 1176, 0, 0, 0, 1178, 0, 0, 0], 
[1778, 0, 0, 0, 0, 0, 0, 0, 0, 0, 0, 1778, 0, 0, 0, 0, 0, 0, 0, 0, 0, 0, 0, 1184, 1185, 1185, 1185, 1186, 0, 0, 0], 
[0, 0, 1245, 1246, 1247, 0, 0, 0, 0, 0, 0, 0, 0, 0, 0, 0, 0, 0, 0, 0, 0, 0, 0, 0, 0, 0, 0, 0, 0, 0, 0], 
[0, 0, 1253, 1254, 1255, 0, 0, 0, 0, 0, 0, 0, 0, 0, 0, 0, 0, 0, 0, 0, 0, 0, 0, 0, 0, 0, 0, 0, 0, 0, 0], 
[0, 0, 0, 0, 0, 0, 0, 0, 0, 0, 0, 0, 0, 0, 0, 0, 0, 0, 0, 0, 0, 0, 0, 0, 0, 0, 0, 0, 0, 0, 0], 
[0, 0, 0, 0, 0, 0, 0, 0, 0, 0, 0, 0, 0, 0, 0, 0, 0, 0, 0, 0, 0, 0, 0, 0, 0, 0, 0, 0, 0, 0, 0], 
[0, 0, 0, 0, 0, 0, 0, 0, 0, 0, 0, 0, 0, 0, 0, 0, 0, 0, 0, 0, 0, 0, 0, 0, 0, 0, 0, 0, 0, 0, 0], 
[0, 0, 0, 0, 0, 0, 0, 0, 0, 0, 0, 0, 0, 0, 0, 0, 0, 0, 0, 0, 0, 0, 0, 0, 0, 0, 0, 0, 0, 0, 0], 
[0, 0, 0, 0, 0, 0, 0, 0, 0, 0, 0, 0, 0, 0, 0, 0, 0, 0, 0, 0, 0, 0, 0, 0, 0, 0, 0, 0, 0, 0, 0]], 

[[0, 0, 0, 0, 0, 0, 0, 0, 0, 0, 0, 0, 0, 0, 0, 0, 0, 0, 0, 0, 1695, 0, 0, 0, 0, 0, 0, 0, 0, 0, 0], 
[0, 0, 0, 0, 0, 0, 0, 0, 0, 0, 0, 0, 0, 0, 0, 0, 0, 0, 0, 0, 1703, 0, 0, 0, 0, 0, 0, 0, 0, 0, 0], 
[0, 0, 0, 0, 0, 0, 0, 0, 0, 0, 0, 0, 0, 0, 0, 0, 0, 0, 0, 0, 1663, 0, 0, 0, 0, 0, 0, 0, 0, 0, 0], 
[0, 0, 0, 0, 0, 0, 0, 0, 0, 0, 0, 0, 0, 0, 0, 0, 0, 0, 0, 0, 0, 0, 0, 0, 0, 1712, 0, 0, 0, 0, 0], 
[0, 0, 0, 0, 1674, 2083, 2085, 1675, 0, 0, 0, 0, 0, 0, 0, 0, 0, 0, 0, 0, 0, 0, 0, 0, 0, 1720, 0, 0, 0, 0, 0], 
[0, 0, 0, 0, 1674, 2091, 2093, 1675, 0, 0, 0, 0, 0, 0, 0, 0, 0, 0, 0, 0, 0, 0, 0, 0, 0, 1723, 0, 0, 0, 0, 0], 
[0, 0, 0, 0, 0, 0, 0, 0, 0, 0, 0, 0, 0, 0, 0, 0, 0, 0, 0, 0, 0, 0, 0, 0, 0, 1731, 0, 0, 0, 0, 0], 
[0, 0, 0, 0, 0, 0, 0, 0, 0, 0, 0, 0, 0, 0, 0, 0, 0, 0, 0, 0, 0, 0, 0, 0, 0, 0, 0, 0, 0, 0, 0], 
[0, 0, 0, 0, 0, 0, 0, 0, 0, 0, 0, 0, 0, 0, 0, 0, 0, 0, 0, 0, 0, 0, 0, 0, 0, 0, 0, 0, 0, 0, 0], 
[0, 0, 0, 0, 0, 0, 0, 0, 0, 0, 0, 0, 0, 0, 0, 0, 0, 0, 0, 0, 0, 0, 0, 0, 0, 0, 0, 0, 0, 0, 0], 
[0, 0, 0, 0, 0, 0, 0, 0, 0, 0, 0, 0, 0, 0, 0, 0, 0, 0, 0, 0, 0, 0, 0, 0, 0, 0, 0, 0, 0, 0, 0], 
[0, 0, 0, 0, 0, 0, 0, 0, 0, 0, 0, 0, 0, 0, 0, 0, 0, 0, 0, 0, 0, 0, 0, 0, 0, 0, 0, 0, 0, 0, 0], 
[0, 0, 0, 0, 0, 0, 0, 0, 0, 0, 0, 0, 0, 0, 0, 0, 0, 0, 0, 0, 0, 0, 0, 0, 0, 0, 0, 0, 0, 0, 0], 
[0, 0, 0, 0, 0, 0, 0, 0, 0, 0, 0, 0, 0, 0, 0, 0, 0, 0, 0, 0, 0, 0, 0, 0, 0, 0, 0, 0, 0, 0, 0], 
[0, 0, 0, 0, 0, 0, 0, 0, 0, 0, 0, 0, 0, 0, 0, 0, 0, 0, 0, 0, 0, 0, 0, 0, 0, 0, 0, 0, 0, 0, 0]]]
}
}
