{
	"Map": {
		"id": 10,
		"map_display_x": 0,
		"map_display_y": 0,
		"width": 20,
		"height": 17,
		"xsize": 20,
		"ysize": 17,
		"zsize": 3,
		"Name" : "Cedolan Gym",
		"Parent" : "Cedolan City",
		"Tileset" : "Gyms interior",
		"BattleBack" : "",
		"Autoplay_bgm" : true,
		"BGM" : "gym",
		"Autoplay_bgs" : false,
		"BGS" : "",
		"Encounter_list" : [],
		"Encounter_step" : 30,
		"table": [[[400, 401, 402, 402, 402, 402, 403, 402, 402, 402, 402, 405, 406, 384, 384, 384, 384, 384, 384, 384], 
[408, 409, 410, 410, 412, 412, 411, 412, 412, 410, 410, 413, 414, 384, 384, 384, 384, 384, 384, 384], 
[408, 417, 418, 418, 418, 418, 418, 418, 418, 418, 418, 421, 414, 384, 384, 384, 384, 384, 384, 384], 
[408, 425, 426, 427, 427, 435, 427, 435, 427, 427, 428, 429, 414, 384, 384, 384, 384, 384, 384, 384], 
[408, 433, 434, 442, 442, 442, 459, 442, 442, 442, 434, 437, 414, 384, 384, 384, 384, 384, 384, 384], 
[408, 441, 442, 442, 450, 466, 467, 468, 450, 442, 442, 434, 414, 384, 384, 384, 384, 384, 384, 384], 
[408, 449, 442, 442, 466, 467, 467, 467, 468, 442, 442, 442, 414, 384, 384, 384, 384, 384, 384, 384], 
[408, 449, 442, 450, 434, 436, 459, 436, 434, 450, 442, 442, 414, 384, 384, 384, 384, 384, 384, 384], 
[408, 457, 442, 451, 452, 452, 452, 452, 452, 453, 442, 450, 414, 384, 384, 384, 384, 384, 384, 384], 
[408, 449, 442, 434, 436, 434, 444, 434, 436, 434, 442, 442, 414, 384, 384, 384, 384, 384, 384, 384], 
[408, 457, 442, 442, 451, 452, 452, 452, 453, 442, 442, 450, 414, 384, 384, 384, 384, 384, 384, 384], 
[408, 449, 442, 442, 434, 434, 444, 434, 434, 442, 442, 442, 414, 384, 384, 384, 384, 384, 384, 384], 
[416, 447, 452, 452, 446, 447, 452, 452, 446, 447, 452, 452, 422, 384, 384, 384, 384, 384, 384, 384], 
[424, 447, 452, 452, 454, 455, 452, 452, 454, 455, 452, 452, 430, 384, 384, 384, 384, 384, 384, 384], 
[432, 447, 452, 452, 452, 452, 452, 452, 452, 452, 452, 452, 438, 384, 384, 384, 384, 384, 384, 384], 
[384, 384, 384, 384, 384, 384, 384, 384, 384, 384, 384, 384, 384, 384, 384, 384, 384, 384, 384, 384], 
[384, 384, 384, 384, 384, 384, 384, 384, 384, 384, 384, 384, 384, 384, 384, 384, 384, 384, 384, 384]], 

[[0, 0, 0, 0, 0, 0, 0, 0, 0, 0, 0, 0, 0, 0, 0, 0, 0, 0, 0, 0], 
[0, 0, 0, 0, 0, 0, 0, 0, 0, 0, 0, 0, 0, 0, 0, 0, 0, 0, 0, 0], 
[0, 0, 0, 0, 0, 0, 0, 0, 0, 0, 0, 0, 0, 0, 0, 0, 0, 0, 0, 0], 
[0, 0, 0, 0, 0, 0, 0, 0, 0, 0, 0, 0, 0, 0, 0, 0, 0, 0, 0, 0], 
[0, 0, 0, 0, 0, 0, 0, 0, 0, 0, 0, 0, 0, 0, 0, 0, 0, 0, 0, 0], 
[0, 0, 0, 0, 0, 461, 462, 463, 0, 0, 0, 0, 0, 0, 0, 0, 0, 0, 0, 0], 
[0, 0, 0, 0, 0, 469, 470, 471, 0, 0, 0, 0, 0, 0, 0, 0, 0, 0, 0, 0], 
[0, 0, 0, 0, 0, 0, 0, 0, 0, 0, 0, 0, 0, 0, 0, 0, 0, 0, 0, 0], 
[0, 0, 0, 0, 0, 0, 0, 0, 0, 0, 0, 0, 0, 0, 0, 0, 0, 0, 0, 0], 
[0, 0, 0, 0, 0, 0, 0, 0, 0, 0, 0, 0, 0, 0, 0, 0, 0, 0, 0, 0], 
[0, 0, 0, 0, 0, 0, 0, 0, 0, 0, 0, 0, 0, 0, 0, 0, 0, 0, 0, 0], 
[0, 0, 0, 0, 385, 0, 0, 0, 385, 0, 0, 0, 0, 0, 0, 0, 0, 0, 0, 0], 
[0, 0, 0, 0, 393, 0, 0, 0, 393, 0, 0, 0, 0, 0, 0, 0, 0, 0, 0, 0], 
[0, 0, 0, 0, 0, 0, 0, 0, 0, 0, 0, 0, 0, 0, 0, 0, 0, 0, 0, 0], 
[0, 0, 0, 0, 0, 386, 387, 388, 0, 0, 0, 0, 0, 0, 0, 0, 0, 0, 0, 0], 
[0, 0, 0, 0, 0, 394, 395, 396, 0, 0, 0, 0, 0, 0, 0, 0, 0, 0, 0, 0], 
[0, 0, 0, 0, 0, 0, 0, 0, 0, 0, 0, 0, 0, 0, 0, 0, 0, 0, 0, 0]], 

[[0, 0, 0, 0, 0, 0, 0, 0, 0, 0, 0, 0, 0, 0, 0, 0, 0, 0, 0, 0], 
[0, 0, 0, 0, 0, 0, 0, 0, 0, 0, 0, 0, 0, 0, 0, 0, 0, 0, 0, 0], 
[0, 0, 0, 0, 0, 0, 0, 0, 0, 0, 0, 0, 0, 0, 0, 0, 0, 0, 0, 0], 
[0, 0, 0, 0, 0, 0, 0, 0, 0, 0, 0, 0, 0, 0, 0, 0, 0, 0, 0, 0], 
[0, 0, 0, 0, 0, 0, 0, 0, 0, 0, 0, 0, 0, 0, 0, 0, 0, 0, 0, 0], 
[0, 0, 0, 0, 0, 0, 0, 0, 0, 0, 0, 0, 0, 0, 0, 0, 0, 0, 0, 0], 
[0, 0, 0, 0, 0, 0, 0, 0, 0, 0, 0, 0, 0, 0, 0, 0, 0, 0, 0, 0], 
[0, 0, 0, 0, 0, 0, 0, 0, 0, 0, 0, 0, 0, 0, 0, 0, 0, 0, 0, 0], 
[0, 0, 0, 0, 0, 0, 0, 0, 0, 0, 0, 0, 0, 0, 0, 0, 0, 0, 0, 0], 
[0, 0, 0, 0, 0, 0, 0, 0, 0, 0, 0, 0, 0, 0, 0, 0, 0, 0, 0, 0], 
[0, 0, 0, 0, 0, 0, 0, 0, 0, 0, 0, 0, 0, 0, 0, 0, 0, 0, 0, 0], 
[0, 0, 0, 0, 0, 0, 0, 0, 0, 0, 0, 0, 0, 0, 0, 0, 0, 0, 0, 0], 
[0, 0, 0, 0, 0, 0, 0, 0, 0, 0, 0, 0, 0, 0, 0, 0, 0, 0, 0, 0], 
[0, 0, 0, 0, 0, 0, 0, 0, 0, 0, 0, 0, 0, 0, 0, 0, 0, 0, 0, 0], 
[0, 0, 0, 0, 0, 0, 0, 0, 0, 0, 0, 0, 0, 0, 0, 0, 0, 0, 0, 0], 
[0, 0, 0, 0, 0, 0, 0, 0, 0, 0, 0, 0, 0, 0, 0, 0, 0, 0, 0, 0], 
[0, 0, 0, 0, 0, 0, 0, 0, 0, 0, 0, 0, 0, 0, 0, 0, 0, 0, 0, 0]]]
}
}
