{
	"Map": {
		"id": 49,
		"map_display_x": 0,
		"map_display_y": 0,
		"width": 34,
		"height": 29,
		"xsize": 34,
		"ysize": 29,
		"zsize": 3,
		"Name" : "Rock Cave",
		"Parent" : "Route 7",
		"Tileset" : "Caves",
		"BattleBack" : "",
		"Autoplay_bgm" : true,
		"BGM" : "Cave",
		"Autoplay_bgs" : false,
		"BGS" : "",
		"Encounter_list" : [],
		"Encounter_step" : 30,
		"table": [[[513, 513, 513, 513, 513, 513, 513, 513, 513, 513, 513, 513, 513, 513, 513, 513, 513, 513, 513, 513, 513, 513, 513, 513, 513, 513, 513, 513, 513, 513, 513, 513, 513, 513], 
[513, 513, 513, 513, 513, 513, 513, 513, 513, 513, 513, 513, 513, 513, 513, 513, 513, 513, 513, 513, 513, 513, 513, 513, 513, 513, 513, 513, 513, 513, 513, 513, 513, 513], 
[513, 513, 513, 513, 513, 513, 513, 513, 513, 513, 513, 513, 513, 513, 513, 513, 513, 513, 513, 513, 513, 513, 513, 513, 513, 513, 513, 513, 513, 513, 513, 513, 513, 513], 
[513, 513, 513, 513, 513, 513, 513, 513, 513, 513, 513, 513, 513, 513, 513, 513, 513, 513, 513, 513, 513, 513, 513, 513, 513, 513, 513, 513, 513, 513, 513, 513, 513, 513], 
[513, 513, 513, 513, 513, 513, 513, 513, 513, 513, 513, 513, 513, 513, 513, 513, 513, 513, 513, 513, 513, 513, 513, 513, 513, 513, 513, 513, 513, 513, 513, 513, 513, 513], 
[513, 513, 513, 513, 513, 513, 513, 513, 513, 610, 610, 610, 610, 610, 610, 610, 610, 610, 610, 610, 610, 610, 610, 610, 513, 513, 513, 513, 513, 513, 513, 513, 513, 513], 
[513, 513, 513, 513, 513, 513, 513, 513, 513, 610, 610, 610, 610, 610, 610, 610, 610, 610, 610, 610, 610, 610, 610, 610, 513, 513, 513, 513, 513, 513, 513, 513, 513, 513], 
[513, 513, 513, 513, 513, 513, 513, 513, 513, 610, 610, 610, 549, 610, 610, 610, 609, 610, 610, 610, 610, 611, 610, 610, 513, 513, 513, 513, 513, 513, 513, 513, 513, 513], 
[513, 513, 513, 513, 513, 513, 513, 513, 513, 610, 610, 610, 610, 610, 610, 610, 609, 610, 610, 610, 610, 611, 610, 610, 610, 610, 610, 513, 513, 513, 513, 513, 513, 513], 
[513, 513, 513, 513, 513, 513, 513, 610, 610, 610, 610, 610, 610, 610, 610, 610, 617, 618, 618, 618, 618, 619, 610, 610, 610, 610, 610, 513, 513, 513, 513, 513, 513, 513], 
[513, 513, 513, 513, 513, 513, 513, 610, 610, 610, 610, 610, 610, 610, 610, 610, 610, 610, 610, 610, 610, 610, 610, 610, 610, 610, 610, 513, 513, 513, 513, 513, 513, 513], 
[513, 513, 513, 513, 513, 513, 513, 658, 658, 659, 610, 610, 610, 610, 610, 610, 610, 610, 610, 610, 610, 610, 610, 610, 610, 610, 610, 513, 513, 513, 513, 513, 513, 513], 
[513, 513, 513, 513, 513, 513, 513, 666, 666, 667, 541, 610, 610, 610, 610, 610, 610, 610, 610, 610, 610, 542, 543, 610, 610, 610, 610, 513, 513, 513, 513, 513, 513, 513], 
[513, 513, 513, 513, 513, 513, 513, 666, 666, 676, 659, 610, 610, 610, 610, 610, 610, 610, 610, 610, 610, 550, 551, 610, 610, 610, 610, 513, 513, 513, 513, 513, 513, 513], 
[513, 513, 513, 513, 513, 513, 513, 666, 666, 666, 667, 610, 610, 610, 610, 610, 610, 610, 610, 610, 610, 610, 610, 610, 541, 610, 610, 513, 513, 513, 513, 513, 513, 513], 
[513, 513, 513, 513, 513, 513, 513, 666, 666, 666, 667, 610, 610, 610, 610, 610, 610, 610, 610, 610, 610, 610, 610, 610, 610, 610, 610, 513, 513, 513, 513, 513, 513, 513], 
[513, 513, 513, 513, 513, 513, 513, 513, 513, 513, 513, 513, 513, 513, 513, 610, 610, 610, 610, 610, 610, 610, 610, 610, 610, 610, 610, 513, 513, 513, 513, 513, 513, 513], 
[513, 513, 513, 513, 513, 513, 513, 513, 513, 513, 513, 513, 513, 513, 513, 658, 658, 659, 610, 610, 610, 513, 513, 513, 513, 513, 513, 513, 513, 513, 513, 513, 513, 513], 
[513, 513, 513, 513, 513, 513, 513, 513, 513, 513, 513, 513, 513, 513, 513, 666, 666, 667, 610, 610, 610, 513, 513, 513, 513, 513, 513, 513, 513, 513, 513, 513, 513, 513], 
[513, 513, 513, 513, 513, 513, 513, 513, 513, 513, 513, 513, 513, 513, 513, 666, 666, 676, 659, 610, 610, 513, 513, 513, 513, 513, 513, 513, 513, 513, 513, 513, 513, 513], 
[513, 513, 513, 513, 513, 513, 513, 513, 513, 513, 513, 513, 513, 513, 513, 513, 666, 666, 667, 610, 610, 513, 513, 513, 513, 513, 513, 513, 513, 513, 513, 513, 513, 513], 
[513, 513, 513, 513, 513, 513, 513, 513, 513, 513, 513, 513, 513, 513, 513, 513, 666, 666, 676, 658, 658, 513, 513, 513, 513, 513, 513, 513, 513, 513, 513, 513, 513, 513], 
[513, 513, 513, 513, 513, 513, 513, 513, 513, 513, 513, 513, 513, 513, 513, 513, 666, 666, 666, 666, 666, 513, 513, 513, 513, 513, 513, 513, 513, 513, 513, 513, 513, 513], 
[513, 513, 513, 513, 513, 513, 513, 513, 513, 513, 513, 513, 513, 513, 513, 513, 666, 666, 666, 666, 666, 513, 513, 513, 513, 513, 513, 513, 513, 513, 513, 513, 513, 513], 
[513, 513, 513, 513, 513, 513, 513, 513, 513, 513, 513, 513, 513, 513, 513, 513, 513, 513, 513, 513, 513, 513, 513, 513, 513, 513, 513, 513, 513, 513, 513, 513, 513, 513], 
[513, 513, 513, 513, 513, 513, 513, 513, 513, 513, 513, 513, 513, 513, 513, 513, 513, 513, 513, 513, 513, 513, 513, 513, 513, 513, 513, 513, 513, 513, 513, 513, 513, 513], 
[513, 513, 513, 513, 513, 513, 513, 513, 513, 513, 513, 513, 513, 513, 513, 513, 513, 513, 513, 513, 513, 513, 513, 513, 513, 513, 513, 513, 513, 513, 513, 513, 513, 513], 
[513, 513, 513, 513, 513, 513, 513, 513, 513, 513, 513, 513, 513, 513, 513, 513, 513, 513, 513, 513, 513, 513, 513, 513, 513, 513, 513, 513, 513, 513, 513, 513, 513, 513], 
[513, 513, 513, 513, 513, 513, 513, 513, 513, 513, 513, 513, 513, 513, 513, 513, 513, 513, 513, 513, 513, 513, 513, 513, 513, 513, 513, 513, 513, 513, 513, 513, 513, 513]], 

[[0, 0, 0, 0, 0, 0, 0, 0, 0, 0, 0, 0, 0, 0, 0, 0, 0, 0, 0, 0, 0, 0, 0, 0, 0, 0, 0, 0, 0, 0, 0, 0, 0, 0], 
[0, 0, 0, 0, 0, 0, 0, 0, 0, 0, 0, 0, 0, 0, 0, 0, 0, 0, 0, 0, 0, 0, 0, 0, 0, 0, 0, 0, 0, 0, 0, 0, 0, 0], 
[0, 0, 0, 0, 0, 0, 0, 0, 0, 0, 0, 0, 0, 0, 0, 0, 0, 0, 0, 0, 0, 0, 0, 0, 0, 0, 0, 0, 0, 0, 0, 0, 0, 0], 
[0, 0, 0, 0, 0, 0, 0, 0, 0, 0, 0, 0, 0, 0, 0, 0, 0, 0, 0, 0, 0, 0, 0, 0, 0, 0, 0, 0, 0, 0, 0, 0, 0, 0], 
[0, 0, 0, 0, 0, 0, 0, 0, 510, 521, 521, 521, 521, 521, 521, 521, 521, 521, 521, 521, 521, 521, 521, 521, 511, 0, 0, 0, 0, 0, 0, 0, 0, 0], 
[0, 0, 0, 0, 0, 0, 0, 0, 514, 510, 521, 521, 521, 521, 521, 521, 521, 521, 521, 521, 521, 521, 521, 511, 512, 0, 0, 0, 0, 0, 0, 0, 0, 0], 
[0, 0, 0, 0, 0, 0, 0, 0, 514, 514, 565, 557, 0, 0, 557, 504, 601, 602, 602, 602, 602, 603, 506, 512, 512, 0, 0, 0, 0, 0, 0, 0, 0, 0], 
[0, 0, 0, 0, 0, 0, 0, 510, 522, 514, 566, 0, 0, 0, 0, 512, 0, 0, 0, 0, 455, 0, 514, 512, 520, 521, 521, 511, 0, 0, 0, 0, 0, 0], 
[0, 0, 0, 0, 0, 0, 510, 522, 0, 514, 559, 0, 0, 0, 0, 512, 0, 0, 0, 0, 0, 0, 514, 520, 521, 521, 511, 512, 0, 0, 0, 0, 0, 0], 
[0, 0, 0, 0, 0, 0, 514, 510, 521, 522, 567, 0, 0, 0, 0, 512, 0, 0, 0, 0, 0, 0, 514, 0, 0, 0, 512, 512, 0, 0, 0, 0, 0, 0], 
[0, 0, 0, 0, 0, 0, 514, 514, 557, 0, 0, 0, 0, 0, 447, 520, 521, 521, 539, 521, 521, 521, 522, 0, 0, 0, 512, 512, 0, 0, 0, 0, 0, 0], 
[0, 0, 0, 0, 0, 0, 514, 514, 0, 0, 0, 0, 0, 0, 0, 0, 0, 0, 0, 0, 0, 0, 0, 0, 0, 0, 512, 512, 0, 0, 0, 0, 0, 0], 
[0, 0, 0, 0, 0, 0, 514, 514, 0, 0, 0, 0, 0, 0, 0, 0, 0, 0, 0, 0, 0, 0, 0, 0, 0, 0, 512, 512, 0, 0, 0, 0, 0, 0], 
[0, 0, 0, 0, 0, 0, 514, 514, 0, 0, 0, 0, 0, 0, 0, 0, 0, 0, 0, 0, 0, 0, 0, 0, 447, 0, 512, 512, 0, 0, 0, 0, 0, 0], 
[0, 0, 0, 0, 0, 0, 514, 514, 565, 0, 0, 0, 0, 0, 0, 0, 0, 0, 0, 0, 0, 0, 0, 0, 0, 0, 512, 512, 0, 0, 0, 0, 0, 0], 
[0, 0, 0, 0, 0, 0, 514, 518, 505, 505, 505, 507, 508, 509, 505, 506, 0, 0, 557, 557, 0, 0, 0, 0, 0, 0, 512, 512, 0, 0, 0, 0, 0, 0], 
[0, 0, 0, 0, 0, 0, 518, 505, 505, 505, 505, 505, 505, 505, 506, 514, 0, 0, 0, 557, 504, 505, 505, 505, 505, 505, 519, 512, 0, 0, 0, 0, 0, 0], 
[0, 0, 0, 0, 0, 0, 0, 0, 0, 0, 0, 0, 0, 0, 514, 514, 0, 0, 0, 0, 512, 504, 505, 505, 505, 505, 505, 519, 0, 0, 0, 0, 0, 0], 
[0, 0, 0, 0, 0, 0, 0, 0, 0, 0, 0, 0, 0, 0, 514, 514, 0, 0, 0, 0, 512, 512, 0, 0, 0, 0, 0, 0, 0, 0, 0, 0, 0, 0], 
[0, 0, 0, 0, 0, 0, 0, 0, 0, 0, 0, 0, 0, 0, 514, 518, 506, 0, 0, 0, 512, 512, 0, 0, 0, 0, 0, 0, 0, 0, 0, 0, 0, 0], 
[0, 0, 0, 0, 0, 0, 0, 0, 0, 0, 0, 0, 0, 0, 518, 506, 514, 0, 0, 0, 515, 512, 0, 0, 0, 0, 0, 0, 0, 0, 0, 0, 0, 0], 
[0, 0, 0, 0, 0, 0, 0, 0, 0, 0, 0, 0, 0, 0, 0, 514, 514, 0, 0, 0, 512, 512, 0, 0, 0, 0, 0, 0, 0, 0, 0, 0, 0, 0], 
[0, 0, 0, 0, 0, 0, 0, 0, 0, 0, 0, 0, 0, 0, 0, 514, 514, 0, 0, 0, 512, 512, 0, 0, 0, 0, 0, 0, 0, 0, 0, 0, 0, 0], 
[0, 0, 0, 0, 0, 0, 0, 0, 0, 0, 0, 0, 0, 0, 0, 514, 518, 505, 505, 505, 519, 512, 0, 0, 0, 0, 0, 0, 0, 0, 0, 0, 0, 0], 
[0, 0, 0, 0, 0, 0, 0, 0, 0, 0, 0, 0, 0, 0, 0, 518, 505, 505, 505, 505, 505, 519, 0, 0, 0, 0, 0, 0, 0, 0, 0, 0, 0, 0], 
[0, 0, 0, 0, 0, 0, 0, 0, 0, 0, 0, 0, 0, 0, 0, 0, 0, 0, 0, 0, 0, 0, 0, 0, 0, 0, 0, 0, 0, 0, 0, 0, 0, 0], 
[0, 0, 0, 0, 0, 0, 0, 0, 0, 0, 0, 0, 0, 0, 0, 0, 0, 0, 0, 0, 0, 0, 0, 0, 0, 0, 0, 0, 0, 0, 0, 0, 0, 0], 
[0, 0, 0, 0, 0, 0, 0, 0, 0, 0, 0, 0, 0, 0, 0, 0, 0, 0, 0, 0, 0, 0, 0, 0, 0, 0, 0, 0, 0, 0, 0, 0, 0, 0], 
[0, 0, 0, 0, 0, 0, 0, 0, 0, 0, 0, 0, 0, 0, 0, 0, 0, 0, 0, 0, 0, 0, 0, 0, 0, 0, 0, 0, 0, 0, 0, 0, 0, 0]], 

[[0, 0, 0, 0, 0, 0, 0, 0, 0, 0, 0, 0, 0, 0, 0, 0, 0, 0, 0, 0, 0, 0, 0, 0, 0, 0, 0, 0, 0, 0, 0, 0, 0, 0], 
[0, 0, 0, 0, 0, 0, 0, 0, 0, 0, 0, 0, 0, 0, 0, 0, 0, 0, 0, 0, 0, 0, 0, 0, 0, 0, 0, 0, 0, 0, 0, 0, 0, 0], 
[0, 0, 0, 0, 0, 0, 0, 0, 0, 0, 0, 0, 0, 0, 0, 0, 0, 0, 0, 0, 0, 0, 0, 0, 0, 0, 0, 0, 0, 0, 0, 0, 0, 0], 
[0, 0, 0, 0, 0, 0, 0, 0, 0, 0, 0, 0, 0, 0, 0, 0, 0, 0, 0, 0, 0, 0, 0, 0, 0, 0, 0, 0, 0, 0, 0, 0, 0, 0], 
[0, 0, 0, 0, 0, 0, 0, 0, 0, 0, 0, 0, 0, 0, 0, 0, 0, 0, 0, 0, 0, 0, 0, 0, 0, 0, 0, 0, 0, 0, 0, 0, 0, 0], 
[0, 0, 0, 0, 0, 0, 0, 0, 0, 0, 0, 0, 0, 0, 0, 0, 0, 0, 0, 0, 0, 0, 0, 0, 0, 0, 0, 0, 0, 0, 0, 0, 0, 0], 
[0, 0, 0, 0, 0, 0, 0, 0, 0, 0, 558, 0, 0, 0, 0, 0, 0, 0, 0, 0, 0, 0, 0, 0, 0, 0, 0, 0, 0, 0, 0, 0, 0, 0], 
[0, 0, 0, 0, 0, 0, 0, 0, 0, 0, 0, 0, 0, 0, 0, 0, 0, 0, 0, 0, 0, 0, 0, 0, 0, 0, 0, 0, 0, 0, 0, 0, 0, 0], 
[0, 0, 0, 0, 0, 0, 0, 0, 0, 0, 0, 0, 0, 0, 0, 0, 0, 0, 0, 0, 0, 0, 0, 433, 434, 435, 0, 0, 0, 0, 0, 0, 0, 0], 
[0, 0, 0, 0, 0, 0, 0, 0, 0, 0, 0, 0, 0, 0, 0, 0, 0, 0, 0, 0, 0, 0, 0, 441, 442, 443, 0, 0, 0, 0, 0, 0, 0, 0], 
[0, 0, 0, 0, 0, 0, 0, 0, 0, 0, 0, 0, 0, 0, 0, 0, 0, 0, 0, 0, 0, 0, 0, 0, 0, 0, 0, 0, 0, 0, 0, 0, 0, 0], 
[0, 0, 0, 0, 0, 0, 0, 0, 0, 0, 0, 0, 0, 0, 0, 0, 0, 0, 0, 0, 0, 0, 0, 0, 0, 0, 0, 0, 0, 0, 0, 0, 0, 0], 
[0, 0, 0, 0, 0, 0, 0, 0, 0, 0, 0, 0, 0, 0, 0, 0, 0, 0, 0, 0, 0, 0, 0, 0, 0, 0, 0, 0, 0, 0, 0, 0, 0, 0], 
[0, 0, 0, 0, 0, 0, 0, 0, 0, 0, 0, 0, 0, 0, 0, 0, 0, 0, 0, 0, 0, 0, 0, 0, 0, 0, 0, 0, 0, 0, 0, 0, 0, 0], 
[0, 0, 0, 0, 0, 0, 0, 0, 0, 0, 0, 0, 0, 0, 0, 0, 0, 0, 0, 0, 0, 0, 0, 0, 0, 0, 0, 0, 0, 0, 0, 0, 0, 0], 
[0, 0, 0, 0, 0, 0, 0, 0, 0, 0, 0, 0, 516, 0, 0, 0, 0, 0, 0, 0, 0, 0, 0, 0, 0, 0, 0, 0, 0, 0, 0, 0, 0, 0], 
[0, 0, 0, 0, 0, 0, 0, 0, 0, 0, 0, 0, 0, 0, 0, 0, 0, 0, 0, 0, 0, 0, 0, 0, 0, 0, 0, 0, 0, 0, 0, 0, 0, 0], 
[0, 0, 0, 0, 0, 0, 0, 0, 0, 0, 0, 0, 0, 0, 0, 0, 0, 0, 0, 0, 0, 0, 0, 0, 0, 0, 0, 0, 0, 0, 0, 0, 0, 0], 
[0, 0, 0, 0, 0, 0, 0, 0, 0, 0, 0, 0, 0, 0, 0, 0, 0, 0, 0, 0, 0, 0, 0, 0, 0, 0, 0, 0, 0, 0, 0, 0, 0, 0], 
[0, 0, 0, 0, 0, 0, 0, 0, 0, 0, 0, 0, 0, 0, 0, 0, 0, 0, 0, 0, 0, 0, 0, 0, 0, 0, 0, 0, 0, 0, 0, 0, 0, 0], 
[0, 0, 0, 0, 0, 0, 0, 0, 0, 0, 0, 0, 0, 0, 0, 0, 0, 0, 0, 0, 0, 0, 0, 0, 0, 0, 0, 0, 0, 0, 0, 0, 0, 0], 
[0, 0, 0, 0, 0, 0, 0, 0, 0, 0, 0, 0, 0, 0, 0, 0, 0, 0, 0, 0, 0, 0, 0, 0, 0, 0, 0, 0, 0, 0, 0, 0, 0, 0], 
[0, 0, 0, 0, 0, 0, 0, 0, 0, 0, 0, 0, 0, 0, 0, 0, 0, 0, 0, 0, 0, 0, 0, 0, 0, 0, 0, 0, 0, 0, 0, 0, 0, 0], 
[0, 0, 0, 0, 0, 0, 0, 0, 0, 0, 0, 0, 0, 0, 0, 0, 0, 0, 0, 0, 0, 0, 0, 0, 0, 0, 0, 0, 0, 0, 0, 0, 0, 0], 
[0, 0, 0, 0, 0, 0, 0, 0, 0, 0, 0, 0, 0, 0, 0, 0, 0, 0, 0, 0, 0, 0, 0, 0, 0, 0, 0, 0, 0, 0, 0, 0, 0, 0], 
[0, 0, 0, 0, 0, 0, 0, 0, 0, 0, 0, 0, 0, 0, 0, 0, 0, 0, 0, 0, 0, 0, 0, 0, 0, 0, 0, 0, 0, 0, 0, 0, 0, 0], 
[0, 0, 0, 0, 0, 0, 0, 0, 0, 0, 0, 0, 0, 0, 0, 0, 0, 0, 0, 0, 0, 0, 0, 0, 0, 0, 0, 0, 0, 0, 0, 0, 0, 0], 
[0, 0, 0, 0, 0, 0, 0, 0, 0, 0, 0, 0, 0, 0, 0, 0, 0, 0, 0, 0, 0, 0, 0, 0, 0, 0, 0, 0, 0, 0, 0, 0, 0, 0], 
[0, 0, 0, 0, 0, 0, 0, 0, 0, 0, 0, 0, 0, 0, 0, 0, 0, 0, 0, 0, 0, 0, 0, 0, 0, 0, 0, 0, 0, 0, 0, 0, 0, 0]]]
}
}
