{
	"Map": {
		"id": 62,
		"map_display_x": 0,
		"map_display_y": 0,
		"width": 20,
		"height": 15,
		"xsize": 20,
		"ysize": 15,
		"zsize": 3,
		"Name" : "Battle Factory",
		"Parent" : "Battle Frontier",
		"Tileset" : "Interior general",
		"BattleBack" : "",
		"Autoplay_bgm" : true,
		"BGM" : "PkmRS-BTower",
		"Autoplay_bgs" : false,
		"BGS" : "",
		"Encounter_list" : [],
		"Encounter_step" : 30,
		"table": [[[520, 521, 521, 521, 521, 521, 521, 521, 521, 521, 521, 521, 521, 523, 542, 542, 542, 542, 542, 542], 
[528, 529, 529, 529, 529, 529, 529, 529, 529, 529, 529, 529, 529, 531, 542, 542, 542, 542, 542, 542], 
[633, 633, 651, 641, 641, 633, 633, 633, 633, 651, 641, 641, 633, 655, 542, 542, 542, 542, 542, 542], 
[634, 633, 633, 635, 633, 633, 633, 633, 633, 633, 635, 633, 633, 634, 542, 542, 542, 542, 542, 542], 
[634, 649, 641, 642, 649, 641, 631, 633, 651, 641, 642, 649, 641, 642, 542, 542, 542, 542, 542, 542], 
[634, 624, 624, 624, 624, 624, 624, 624, 624, 624, 624, 624, 624, 624, 542, 542, 542, 542, 542, 542], 
[634, 624, 624, 624, 624, 624, 624, 624, 624, 624, 624, 624, 624, 624, 542, 542, 542, 542, 542, 542], 
[633, 633, 635, 624, 624, 624, 624, 624, 624, 624, 624, 624, 633, 633, 542, 542, 542, 542, 542, 542], 
[542, 542, 542, 542, 635, 624, 624, 624, 624, 624, 542, 542, 542, 542, 542, 542, 542, 542, 542, 542], 
[542, 542, 542, 542, 542, 542, 542, 542, 542, 542, 542, 542, 542, 542, 542, 542, 542, 542, 542, 542], 
[542, 542, 542, 542, 542, 542, 542, 542, 542, 542, 542, 542, 542, 542, 542, 542, 542, 542, 542, 542], 
[542, 542, 542, 542, 542, 542, 542, 542, 542, 542, 542, 542, 542, 542, 542, 542, 542, 542, 542, 542], 
[542, 542, 542, 542, 542, 542, 542, 542, 542, 542, 542, 542, 542, 542, 542, 542, 542, 542, 542, 542], 
[542, 542, 542, 542, 542, 542, 542, 542, 542, 542, 542, 542, 542, 542, 542, 542, 542, 542, 542, 542], 
[542, 542, 542, 542, 542, 542, 542, 542, 542, 542, 542, 542, 542, 542, 542, 542, 542, 542, 542, 542]], 

[[0, 0, 389, 390, 391, 0, 1784, 1785, 0, 389, 390, 391, 0, 0, 0, 0, 0, 0, 0, 0], 
[0, 1968, 397, 398, 399, 1968, 1792, 1793, 1968, 397, 398, 399, 1968, 0, 0, 0, 0, 0, 0, 0], 
[536, 1977, 1963, 0, 1961, 1979, 1800, 1801, 1977, 1963, 0, 1961, 1979, 539, 0, 0, 0, 0, 0, 0], 
[0, 1985, 1987, 0, 1985, 1987, 0, 1725, 1985, 1987, 0, 1985, 1987, 0, 0, 0, 0, 0, 0, 0], 
[0, 0, 0, 0, 0, 0, 0, 1733, 0, 0, 0, 0, 0, 0, 0, 0, 0, 0, 0, 0], 
[1784, 1785, 0, 0, 0, 0, 0, 0, 0, 0, 0, 0, 1784, 1785, 0, 0, 0, 0, 0, 0], 
[1792, 1793, 0, 0, 0, 0, 0, 0, 0, 0, 0, 0, 1792, 1793, 0, 0, 0, 0, 0, 0], 
[1800, 1801, 0, 0, 0, 0, 0, 0, 0, 0, 0, 0, 1800, 1801, 0, 0, 0, 0, 0, 0], 
[0, 0, 0, 0, 0, 1245, 1246, 1246, 1247, 0, 0, 0, 0, 0, 0, 0, 0, 0, 0, 0], 
[0, 0, 0, 0, 0, 1253, 1254, 1254, 1255, 0, 0, 0, 0, 0, 0, 0, 0, 0, 0, 0], 
[0, 0, 0, 0, 0, 0, 0, 0, 0, 0, 0, 0, 0, 0, 0, 0, 0, 0, 0, 0], 
[0, 0, 0, 0, 0, 0, 0, 0, 0, 0, 0, 0, 0, 0, 0, 0, 0, 0, 0, 0], 
[0, 0, 0, 0, 0, 0, 0, 0, 0, 0, 0, 0, 0, 0, 0, 0, 0, 0, 0, 0], 
[0, 0, 0, 0, 0, 0, 0, 0, 0, 0, 0, 0, 0, 0, 0, 0, 0, 0, 0, 0], 
[0, 0, 0, 0, 0, 0, 0, 0, 0, 0, 0, 0, 0, 0, 0, 0, 0, 0, 0, 0]], 

[[0, 0, 0, 0, 0, 0, 0, 0, 0, 0, 0, 0, 0, 0, 0, 0, 0, 0, 0, 0], 
[0, 0, 0, 0, 0, 0, 0, 0, 0, 0, 0, 0, 0, 0, 0, 0, 0, 0, 0, 0], 
[0, 0, 0, 0, 1859, 0, 1693, 1695, 0, 0, 0, 1859, 0, 0, 0, 0, 0, 0, 0, 0], 
[0, 0, 0, 0, 1867, 0, 1701, 1703, 0, 0, 0, 1867, 0, 0, 0, 0, 0, 0, 0, 0], 
[0, 0, 0, 0, 0, 0, 1709, 0, 0, 0, 0, 0, 0, 0, 0, 0, 0, 0, 0, 0], 
[0, 0, 0, 0, 0, 0, 0, 0, 0, 0, 0, 0, 0, 0, 0, 0, 0, 0, 0, 0], 
[0, 0, 0, 0, 0, 0, 0, 0, 0, 0, 0, 0, 0, 0, 0, 0, 0, 0, 0, 0], 
[0, 0, 0, 0, 0, 0, 0, 0, 0, 0, 0, 0, 0, 0, 0, 0, 0, 0, 0, 0], 
[0, 0, 0, 0, 0, 0, 0, 0, 0, 0, 0, 0, 0, 0, 0, 0, 0, 0, 0, 0], 
[0, 0, 0, 0, 0, 0, 0, 0, 0, 0, 0, 0, 0, 0, 0, 0, 0, 0, 0, 0], 
[0, 0, 0, 0, 0, 0, 0, 0, 0, 0, 0, 0, 0, 0, 0, 0, 0, 0, 0, 0], 
[0, 0, 0, 0, 0, 0, 0, 0, 0, 0, 0, 0, 0, 0, 0, 0, 0, 0, 0, 0], 
[0, 0, 0, 0, 0, 0, 0, 0, 0, 0, 0, 0, 0, 0, 0, 0, 0, 0, 0, 0], 
[0, 0, 0, 0, 0, 0, 0, 0, 0, 0, 0, 0, 0, 0, 0, 0, 0, 0, 0, 0], 
[0, 0, 0, 0, 0, 0, 0, 0, 0, 0, 0, 0, 0, 0, 0, 0, 0, 0, 0, 0]]]
}
}
