{
	"Map": {
		"id": 19,
		"map_display_x": 0,
		"map_display_y": 0,
		"width": 32,
		"height": 20,
		"xsize": 32,
		"ysize": 20,
		"zsize": 3,
		"Name" : "Cedolan Dept. Rooftop",
		"Parent" : "Cedolan Dept. 1F",
		"Tileset" : "Department store interior",
		"BattleBack" : "",
		"Autoplay_bgm" : true,
		"BGM" : "Poke Mart",
		"Autoplay_bgs" : false,
		"BGS" : "",
		"Encounter_list" : [],
		"Encounter_step" : 30,
		"table": [[[667, 667, 667, 667, 667, 667, 667, 667, 667, 667, 667, 667, 667, 667, 667, 667, 667, 667, 667, 667, 667, 667, 667, 667, 667, 667, 667, 667, 667, 667, 667, 667], 
[667, 667, 667, 667, 667, 667, 667, 667, 667, 667, 667, 667, 667, 667, 667, 667, 667, 667, 667, 667, 667, 667, 667, 667, 667, 667, 667, 667, 667, 667, 667, 667], 
[667, 667, 667, 667, 667, 667, 667, 667, 667, 667, 667, 667, 667, 667, 667, 667, 667, 667, 667, 667, 667, 667, 667, 667, 667, 667, 667, 667, 667, 667, 667, 667], 
[667, 667, 667, 667, 667, 667, 667, 667, 667, 667, 667, 667, 667, 667, 667, 667, 667, 667, 667, 667, 667, 667, 667, 667, 667, 667, 667, 667, 667, 667, 667, 667], 
[667, 667, 667, 667, 667, 667, 667, 667, 667, 667, 667, 667, 667, 667, 667, 667, 667, 667, 667, 667, 667, 667, 667, 667, 667, 667, 667, 667, 667, 667, 667, 667], 
[667, 667, 667, 667, 667, 667, 667, 640, 641, 641, 641, 641, 641, 641, 641, 641, 641, 641, 641, 641, 641, 641, 641, 641, 641, 642, 667, 667, 667, 667, 667, 667], 
[667, 667, 667, 667, 667, 667, 667, 648, 649, 649, 649, 649, 649, 649, 649, 649, 649, 649, 649, 649, 649, 649, 649, 649, 649, 650, 667, 667, 667, 667, 667, 667], 
[667, 667, 667, 667, 667, 667, 667, 656, 697, 705, 705, 705, 705, 705, 705, 705, 705, 697, 697, 697, 697, 697, 697, 697, 697, 658, 667, 667, 667, 667, 667, 667], 
[667, 667, 667, 667, 667, 667, 667, 656, 697, 688, 688, 688, 688, 688, 688, 688, 688, 705, 705, 705, 705, 705, 705, 705, 705, 658, 667, 667, 667, 667, 667, 667], 
[667, 667, 667, 667, 667, 667, 667, 656, 697, 688, 688, 688, 688, 688, 688, 688, 688, 688, 688, 688, 688, 688, 688, 688, 688, 658, 667, 667, 667, 667, 667, 667], 
[667, 667, 667, 667, 667, 667, 667, 656, 697, 688, 688, 688, 688, 688, 688, 688, 688, 688, 688, 688, 688, 688, 688, 688, 688, 658, 667, 667, 667, 667, 667, 667], 
[667, 667, 667, 667, 667, 667, 667, 656, 697, 688, 688, 688, 688, 688, 688, 688, 688, 688, 688, 688, 688, 688, 688, 688, 688, 658, 667, 667, 667, 667, 667, 667], 
[667, 667, 667, 667, 667, 667, 667, 664, 697, 688, 688, 688, 688, 688, 688, 688, 688, 688, 688, 688, 688, 688, 688, 688, 688, 666, 667, 667, 667, 667, 667, 667], 
[667, 667, 667, 667, 667, 667, 667, 672, 673, 673, 673, 673, 673, 673, 673, 673, 673, 673, 673, 673, 673, 673, 673, 673, 673, 674, 667, 667, 667, 667, 667, 667], 
[667, 667, 667, 667, 667, 667, 667, 680, 681, 681, 681, 681, 681, 681, 681, 681, 681, 681, 681, 681, 681, 681, 681, 681, 681, 682, 667, 667, 667, 667, 667, 667], 
[667, 667, 667, 667, 667, 667, 667, 680, 681, 675, 676, 677, 675, 676, 677, 675, 676, 677, 675, 676, 677, 675, 676, 677, 681, 682, 667, 667, 667, 667, 667, 667], 
[667, 667, 667, 667, 667, 667, 667, 680, 681, 683, 684, 685, 683, 684, 685, 683, 684, 685, 683, 684, 685, 683, 684, 685, 681, 682, 667, 667, 667, 667, 667, 667], 
[667, 667, 667, 667, 667, 667, 667, 680, 681, 681, 681, 681, 681, 681, 681, 681, 681, 681, 681, 681, 681, 681, 681, 681, 681, 682, 667, 667, 667, 667, 667, 667], 
[667, 667, 667, 667, 667, 667, 667, 680, 681, 675, 676, 677, 675, 676, 677, 675, 676, 677, 675, 676, 677, 675, 676, 677, 681, 682, 667, 667, 667, 667, 667, 667], 
[667, 667, 667, 667, 667, 667, 667, 680, 681, 683, 684, 685, 683, 684, 685, 683, 684, 685, 683, 684, 685, 683, 684, 685, 681, 682, 667, 667, 667, 667, 667, 667]], 

[[0, 0, 0, 0, 0, 0, 0, 0, 0, 0, 0, 0, 0, 0, 0, 0, 0, 0, 0, 0, 0, 0, 0, 0, 0, 0, 0, 0, 0, 0, 0, 0], 
[0, 0, 0, 0, 0, 0, 0, 0, 0, 0, 0, 0, 0, 0, 0, 0, 0, 0, 0, 0, 0, 0, 0, 0, 0, 0, 0, 0, 0, 0, 0, 0], 
[0, 0, 0, 0, 0, 0, 0, 0, 0, 0, 0, 0, 0, 0, 0, 0, 0, 0, 0, 0, 0, 0, 0, 0, 0, 0, 0, 0, 0, 0, 0, 0], 
[0, 0, 0, 0, 0, 0, 0, 0, 0, 0, 0, 0, 0, 0, 0, 0, 0, 0, 0, 0, 0, 0, 0, 0, 0, 0, 0, 0, 0, 0, 0, 0], 
[0, 0, 0, 0, 0, 0, 0, 0, 0, 0, 0, 0, 0, 0, 0, 0, 0, 0, 0, 0, 644, 645, 645, 645, 646, 0, 0, 0, 0, 0, 0, 0], 
[0, 0, 0, 0, 0, 0, 0, 0, 0, 0, 0, 0, 0, 0, 0, 0, 0, 0, 0, 0, 652, 653, 653, 653, 654, 0, 0, 0, 0, 0, 0, 0], 
[0, 0, 0, 0, 0, 0, 0, 0, 0, 0, 0, 0, 0, 0, 0, 0, 0, 723, 723, 723, 660, 661, 661, 652, 654, 0, 0, 0, 0, 0, 0, 0], 
[0, 0, 0, 0, 0, 0, 0, 0, 0, 0, 0, 0, 0, 0, 0, 0, 724, 731, 731, 731, 668, 669, 669, 652, 654, 0, 0, 0, 0, 0, 0, 0], 
[0, 0, 0, 0, 0, 0, 0, 0, 0, 0, 693, 694, 694, 695, 0, 0, 0, 0, 0, 0, 0, 0, 0, 652, 654, 0, 0, 0, 0, 0, 0, 0], 
[0, 0, 0, 0, 0, 0, 0, 0, 0, 0, 701, 702, 702, 703, 0, 0, 0, 0, 0, 0, 0, 0, 693, 652, 654, 0, 0, 0, 0, 0, 0, 0], 
[0, 0, 0, 0, 0, 0, 0, 0, 0, 0, 701, 702, 702, 703, 0, 0, 0, 0, 0, 0, 0, 0, 701, 652, 654, 0, 0, 0, 0, 0, 0, 0], 
[0, 0, 0, 0, 0, 0, 0, 0, 0, 0, 709, 710, 710, 711, 0, 0, 0, 0, 0, 0, 0, 0, 717, 660, 662, 0, 0, 0, 0, 0, 0, 0], 
[0, 0, 0, 0, 0, 0, 0, 0, 665, 665, 665, 665, 665, 665, 665, 665, 665, 665, 665, 665, 665, 665, 665, 668, 670, 0, 0, 0, 0, 0, 0, 0], 
[0, 0, 0, 0, 0, 0, 0, 0, 0, 0, 0, 0, 0, 0, 0, 0, 0, 0, 0, 0, 0, 0, 0, 0, 0, 0, 0, 0, 0, 0, 0, 0], 
[0, 0, 0, 0, 0, 0, 0, 0, 0, 0, 0, 0, 0, 0, 0, 0, 0, 0, 0, 0, 0, 0, 0, 0, 0, 0, 0, 0, 0, 0, 0, 0], 
[0, 0, 0, 0, 0, 0, 0, 0, 0, 0, 0, 0, 0, 0, 0, 0, 0, 0, 0, 0, 0, 0, 0, 0, 0, 0, 0, 0, 0, 0, 0, 0], 
[0, 0, 0, 0, 0, 0, 0, 0, 0, 0, 0, 0, 0, 0, 0, 0, 0, 0, 0, 0, 0, 0, 0, 0, 0, 0, 0, 0, 0, 0, 0, 0], 
[0, 0, 0, 0, 0, 0, 0, 0, 0, 0, 0, 0, 0, 0, 0, 0, 0, 0, 0, 0, 0, 0, 0, 0, 0, 0, 0, 0, 0, 0, 0, 0], 
[0, 0, 0, 0, 0, 0, 0, 0, 0, 0, 0, 0, 0, 0, 0, 0, 0, 0, 0, 0, 0, 0, 0, 0, 0, 0, 0, 0, 0, 0, 0, 0], 
[0, 0, 0, 0, 0, 0, 0, 0, 0, 0, 0, 0, 0, 0, 0, 0, 0, 0, 0, 0, 0, 0, 0, 0, 0, 0, 0, 0, 0, 0, 0, 0]], 

[[0, 0, 0, 0, 0, 0, 0, 0, 0, 0, 0, 0, 0, 0, 0, 0, 0, 0, 0, 0, 0, 0, 0, 0, 0, 0, 0, 0, 0, 0, 0, 0], 
[0, 0, 0, 0, 0, 0, 0, 0, 0, 0, 0, 0, 0, 0, 0, 0, 0, 0, 0, 0, 0, 0, 0, 0, 0, 0, 0, 0, 0, 0, 0, 0], 
[0, 0, 0, 0, 0, 0, 0, 0, 0, 0, 0, 0, 0, 0, 0, 0, 0, 0, 0, 0, 0, 0, 0, 0, 0, 0, 0, 0, 0, 0, 0, 0], 
[0, 0, 0, 0, 0, 0, 0, 0, 0, 0, 0, 0, 0, 0, 0, 0, 0, 0, 0, 0, 0, 0, 0, 0, 0, 0, 0, 0, 0, 0, 0, 0], 
[0, 0, 0, 0, 0, 0, 0, 0, 0, 0, 0, 0, 0, 0, 0, 0, 0, 0, 0, 0, 0, 0, 0, 0, 0, 0, 0, 0, 0, 0, 0, 0], 
[0, 0, 0, 0, 0, 0, 0, 0, 0, 0, 0, 0, 0, 0, 0, 0, 0, 0, 0, 0, 0, 0, 0, 0, 0, 0, 0, 0, 0, 0, 0, 0], 
[0, 0, 0, 0, 0, 0, 0, 0, 0, 0, 0, 0, 0, 0, 0, 0, 0, 0, 0, 0, 0, 534, 0, 0, 0, 0, 0, 0, 0, 0, 0, 0], 
[0, 0, 0, 0, 0, 0, 0, 0, 0, 0, 0, 0, 0, 0, 0, 0, 0, 0, 0, 0, 0, 542, 0, 0, 0, 0, 0, 0, 0, 0, 0, 0], 
[0, 0, 0, 0, 0, 0, 0, 0, 0, 0, 0, 0, 0, 0, 0, 0, 0, 0, 0, 0, 0, 0, 643, 0, 0, 0, 0, 0, 0, 0, 0, 0], 
[0, 0, 0, 0, 0, 0, 0, 0, 0, 0, 716, 712, 713, 715, 0, 0, 0, 0, 0, 0, 0, 0, 651, 0, 0, 0, 0, 0, 0, 0, 0, 0], 
[0, 0, 0, 0, 0, 0, 0, 0, 0, 0, 716, 720, 721, 715, 0, 0, 0, 0, 0, 0, 0, 0, 659, 0, 0, 0, 0, 0, 0, 0, 0, 0], 
[0, 0, 0, 0, 0, 0, 0, 0, 0, 0, 0, 728, 729, 0, 0, 0, 0, 0, 0, 0, 0, 0, 0, 0, 0, 0, 0, 0, 0, 0, 0, 0], 
[0, 0, 0, 0, 0, 0, 0, 0, 0, 0, 0, 0, 0, 0, 0, 0, 0, 0, 0, 0, 0, 0, 0, 665, 665, 0, 0, 0, 0, 0, 0, 0], 
[0, 0, 0, 0, 0, 0, 0, 0, 0, 0, 0, 0, 0, 0, 0, 0, 0, 0, 0, 0, 0, 0, 0, 0, 0, 0, 0, 0, 0, 0, 0, 0], 
[0, 0, 0, 0, 0, 0, 0, 0, 0, 0, 0, 0, 0, 0, 0, 0, 0, 0, 0, 0, 0, 0, 0, 0, 0, 0, 0, 0, 0, 0, 0, 0], 
[0, 0, 0, 0, 0, 0, 0, 0, 0, 0, 0, 0, 0, 0, 0, 0, 0, 0, 0, 0, 0, 0, 0, 0, 0, 0, 0, 0, 0, 0, 0, 0], 
[0, 0, 0, 0, 0, 0, 0, 0, 0, 0, 0, 0, 0, 0, 0, 0, 0, 0, 0, 0, 0, 0, 0, 0, 0, 0, 0, 0, 0, 0, 0, 0], 
[0, 0, 0, 0, 0, 0, 0, 0, 0, 0, 0, 0, 0, 0, 0, 0, 0, 0, 0, 0, 0, 0, 0, 0, 0, 0, 0, 0, 0, 0, 0, 0], 
[0, 0, 0, 0, 0, 0, 0, 0, 0, 0, 0, 0, 0, 0, 0, 0, 0, 0, 0, 0, 0, 0, 0, 0, 0, 0, 0, 0, 0, 0, 0, 0], 
[0, 0, 0, 0, 0, 0, 0, 0, 0, 0, 0, 0, 0, 0, 0, 0, 0, 0, 0, 0, 0, 0, 0, 0, 0, 0, 0, 0, 0, 0, 0, 0]]]
}
}
