{
	"Map": {
		"id": 45,
		"map_display_x": 0,
		"map_display_y": 0,
		"width": 39,
		"height": 24,
		"xsize": 39,
		"ysize": 24,
		"zsize": 3,
		"Name" : "Route 6",
		"Parent" : "Route 6",
		"Tileset" : "Outside",
		"BattleBack" : "",
		"Autoplay_bgm" : true,
		"BGM" : "cinnabar",
		"Autoplay_bgs" : false,
		"BGS" : "",
		"Encounter_list" : [],
		"Encounter_step" : 30,
		"table": [[[385, 385, 385, 385, 385, 385, 385, 386, 286, 388, 385, 388, 386, 389, 386, 388, 286, 388, 385, 385, 385, 385, 385, 385, 385, 385, 385, 387, 385, 810, 809, 808, 809, 808, 809, 808, 809, 808, 809], 
[385, 385, 385, 385, 385, 385, 385, 388, 388, 286, 389, 387, 388, 385, 388, 286, 386, 385, 385, 385, 385, 385, 385, 385, 385, 385, 385, 386, 385, 802, 801, 800, 801, 800, 801, 800, 801, 800, 801], 
[385, 385, 385, 385, 385, 385, 385, 386, 286, 385, 389, 386, 386, 387, 385, 385, 286, 389, 385, 385, 385, 385, 385, 385, 385, 385, 385, 387, 385, 810, 809, 808, 809, 808, 809, 808, 809, 808, 809], 
[385, 385, 385, 385, 385, 385, 385, 389, 386, 286, 385, 387, 385, 387, 388, 286, 386, 386, 385, 385, 385, 385, 385, 385, 385, 385, 385, 385, 385, 802, 801, 800, 801, 800, 801, 800, 801, 800, 801], 
[385, 385, 385, 385, 385, 385, 385, 388, 286, 388, 386, 389, 386, 389, 386, 388, 286, 387, 385, 385, 385, 385, 385, 385, 385, 385, 385, 387, 385, 810, 809, 808, 809, 808, 809, 808, 809, 808, 809], 
[385, 385, 385, 385, 385, 385, 385, 385, 385, 286, 388, 385, 388, 385, 388, 286, 385, 385, 385, 385, 385, 385, 385, 385, 385, 385, 385, 385, 385, 818, 819, 818, 819, 818, 819, 818, 819, 818, 819], 
[385, 385, 385, 385, 385, 385, 385, 389, 286, 386, 386, 387, 386, 387, 385, 386, 286, 387, 385, 385, 385, 385, 385, 385, 385, 385, 385, 387, 385, 385, 385, 385, 385, 385, 385, 385, 385, 385, 385], 
[385, 385, 385, 385, 385, 385, 385, 387, 388, 537, 538, 538, 538, 538, 538, 539, 385, 385, 1233, 1233, 1233, 1233, 1233, 1233, 1233, 1233, 1233, 385, 385, 385, 385, 385, 385, 385, 385, 385, 385, 385, 385], 
[385, 385, 385, 385, 385, 385, 385, 385, 537, 558, 546, 546, 546, 546, 546, 556, 538, 538, 538, 538, 538, 538, 538, 538, 538, 538, 538, 538, 538, 538, 538, 538, 538, 538, 538, 538, 538, 538, 538], 
[385, 385, 385, 385, 385, 385, 385, 387, 545, 546, 546, 546, 546, 546, 546, 546, 546, 546, 546, 546, 546, 546, 546, 546, 546, 546, 546, 546, 546, 546, 546, 546, 546, 546, 546, 546, 546, 546, 546], 
[385, 385, 385, 385, 385, 385, 385, 385, 545, 546, 546, 546, 546, 546, 546, 546, 546, 546, 546, 546, 546, 546, 546, 546, 546, 540, 554, 554, 554, 554, 554, 554, 554, 554, 554, 554, 554, 554, 554], 
[385, 385, 385, 385, 385, 385, 385, 385, 385, 385, 385, 385, 385, 385, 385, 385, 385, 385, 385, 385, 385, 385, 385, 385, 385, 385, 385, 385, 385, 385, 385, 385, 385, 385, 385, 385, 385, 385, 387], 
[385, 385, 385, 385, 385, 385, 385, 385, 385, 385, 385, 385, 385, 385, 385, 385, 385, 385, 385, 385, 385, 385, 385, 385, 385, 385, 385, 389, 388, 385, 388, 385, 388, 387, 386, 385, 387, 388, 385], 
[385, 385, 385, 385, 385, 385, 385, 385, 385, 385, 385, 385, 385, 385, 385, 385, 385, 385, 385, 385, 385, 385, 385, 385, 385, 385, 385, 385, 385, 390, 390, 390, 390, 390, 390, 389, 386, 387, 385], 
[385, 385, 385, 385, 385, 385, 385, 385, 385, 385, 385, 385, 385, 385, 385, 385, 385, 385, 385, 385, 385, 385, 385, 385, 385, 385, 385, 386, 389, 390, 390, 390, 390, 390, 390, 385, 385, 810, 811], 
[385, 385, 385, 385, 385, 385, 385, 385, 385, 385, 385, 385, 385, 385, 385, 385, 385, 385, 385, 385, 385, 385, 385, 385, 385, 178, 168, 389, 385, 390, 390, 390, 390, 390, 390, 386, 389, 802, 801], 
[385, 385, 385, 385, 385, 385, 385, 385, 385, 385, 385, 385, 385, 385, 385, 385, 385, 385, 385, 385, 385, 385, 385, 385, 385, 184, 168, 385, 386, 390, 390, 390, 390, 390, 390, 388, 385, 810, 809], 
[385, 385, 385, 385, 385, 385, 385, 385, 385, 385, 385, 385, 385, 385, 385, 385, 385, 385, 385, 385, 385, 385, 385, 385, 385, 385, 385, 386, 388, 385, 387, 388, 385, 388, 385, 388, 386, 818, 819], 
[385, 385, 385, 385, 385, 385, 385, 385, 385, 385, 385, 385, 385, 385, 385, 385, 385, 385, 385, 385, 385, 385, 385, 385, 385, 385, 385, 388, 385, 385, 385, 385, 385, 385, 385, 385, 388, 385, 385], 
[385, 385, 385, 385, 385, 385, 385, 385, 385, 385, 385, 385, 385, 385, 385, 385, 385, 385, 385, 385, 385, 385, 385, 385, 385, 385, 385, 385, 385, 385, 385, 385, 385, 385, 385, 385, 385, 385, 385], 
[385, 385, 385, 385, 385, 385, 385, 385, 385, 385, 385, 385, 385, 385, 385, 385, 385, 385, 385, 385, 385, 385, 385, 385, 385, 385, 385, 385, 385, 385, 385, 385, 385, 385, 385, 385, 385, 385, 385], 
[385, 385, 385, 385, 385, 385, 385, 385, 385, 385, 385, 385, 385, 385, 385, 385, 385, 385, 385, 385, 385, 385, 385, 385, 385, 385, 385, 385, 385, 385, 385, 385, 385, 385, 385, 385, 385, 385, 385], 
[385, 385, 385, 385, 385, 385, 385, 385, 385, 385, 385, 385, 385, 385, 385, 385, 385, 385, 385, 385, 385, 385, 385, 385, 385, 385, 385, 385, 385, 385, 385, 385, 385, 385, 385, 385, 385, 385, 385], 
[385, 385, 385, 385, 385, 385, 385, 385, 385, 385, 385, 385, 385, 385, 385, 385, 385, 385, 385, 385, 385, 385, 385, 385, 385, 385, 385, 385, 385, 385, 385, 385, 385, 385, 385, 385, 385, 385, 385]], 

[[168, 48, 184, 182, 48, 48, 72, 1664, 0, 0, 0, 0, 0, 0, 0, 0, 0, 1665, 64, 48, 48, 48, 184, 182, 178, 180, 72, 1664, 859, 0, 0, 0, 0, 0, 0, 0, 0, 0, 0], 
[168, 48, 178, 180, 48, 48, 72, 1664, 0, 0, 0, 0, 0, 0, 0, 0, 0, 1665, 64, 48, 48, 48, 48, 48, 184, 182, 72, 1664, 859, 0, 0, 0, 0, 0, 0, 0, 0, 0, 0], 
[168, 180, 184, 182, 48, 48, 72, 1664, 0, 0, 0, 0, 0, 0, 0, 0, 0, 1665, 64, 48, 48, 48, 48, 48, 48, 48, 72, 1664, 859, 0, 0, 0, 0, 0, 0, 0, 0, 0, 0], 
[144, 168, 48, 178, 180, 48, 72, 1664, 0, 0, 0, 0, 0, 0, 0, 0, 0, 1665, 64, 48, 48, 48, 48, 48, 48, 48, 72, 1664, 859, 0, 0, 0, 0, 0, 0, 0, 0, 0, 0], 
[144, 168, 180, 184, 182, 48, 72, 1664, 0, 0, 0, 0, 0, 0, 0, 0, 0, 1665, 64, 48, 48, 48, 48, 48, 48, 48, 72, 1664, 859, 0, 0, 0, 0, 0, 0, 0, 0, 0, 0], 
[144, 144, 168, 48, 178, 180, 72, 1664, 0, 0, 0, 0, 0, 0, 0, 0, 0, 1665, 64, 48, 48, 48, 48, 48, 48, 48, 72, 1664, 859, 0, 0, 0, 0, 0, 0, 0, 0, 0, 0], 
[144, 144, 168, 48, 184, 182, 72, 1664, 0, 0, 0, 0, 0, 0, 0, 0, 0, 1665, 88, 76, 76, 76, 76, 76, 76, 76, 86, 1664, 859, 859, 859, 3352, 3353, 3353, 3353, 3353, 3354, 859, 859], 
[144, 148, 182, 178, 180, 48, 72, 1664, 0, 0, 0, 0, 0, 0, 0, 0, 0, 1673, 0, 0, 0, 0, 0, 0, 0, 0, 0, 1674, 1681, 1681, 1681, 3360, 3361, 3361, 3361, 3361, 3362, 1681, 1682], 
[144, 168, 48, 184, 182, 48, 72, 1664, 0, 0, 0, 0, 0, 0, 0, 0, 0, 0, 0, 0, 0, 0, 0, 0, 0, 0, 0, 0, 0, 0, 3304, 3305, 3306, 3307, 3307, 3308, 3309, 3310, 0], 
[148, 182, 178, 180, 48, 48, 72, 1664, 0, 0, 0, 0, 0, 0, 0, 0, 0, 0, 0, 0, 0, 0, 0, 0, 0, 0, 0, 0, 0, 0, 3312, 3344, 3345, 3345, 3345, 3345, 3346, 3318, 0], 
[168, 48, 184, 182, 48, 48, 72, 1672, 0, 0, 0, 0, 0, 0, 0, 0, 0, 0, 0, 0, 0, 0, 0, 0, 0, 0, 0, 0, 0, 0, 3320, 3384, 3385, 3385, 3385, 3385, 3386, 3326, 0], 
[168, 48, 178, 180, 48, 48, 50, 68, 68, 68, 68, 68, 68, 68, 68, 68, 68, 68, 68, 68, 68, 68, 68, 68, 68, 68, 84, 1699, 1717, 1717, 1717, 1717, 1717, 1717, 1717, 1717, 1717, 0, 0], 
[168, 48, 184, 182, 48, 48, 48, 48, 48, 48, 48, 48, 48, 48, 48, 48, 48, 48, 48, 48, 48, 48, 48, 48, 178, 180, 72, 1707, 0, 0, 0, 0, 0, 0, 0, 0, 0, 0, 0], 
[168, 48, 178, 180, 48, 48, 48, 48, 48, 48, 48, 48, 48, 48, 48, 48, 48, 48, 48, 48, 48, 48, 48, 48, 184, 182, 72, 1707, 0, 0, 0, 0, 0, 0, 0, 0, 0, 0, 0], 
[168, 48, 184, 182, 48, 48, 48, 48, 48, 48, 48, 48, 48, 48, 48, 48, 48, 48, 48, 48, 48, 48, 48, 48, 48, 48, 72, 1707, 0, 0, 0, 0, 0, 0, 0, 0, 1701, 0, 0], 
[146, 180, 48, 48, 178, 180, 48, 48, 48, 48, 48, 178, 180, 178, 180, 48, 48, 48, 48, 178, 180, 178, 180, 48, 48, 0, 1138, 1707, 0, 0, 0, 0, 0, 0, 0, 0, 1708, 0, 0], 
[144, 146, 180, 48, 184, 182, 178, 180, 48, 48, 48, 184, 182, 184, 182, 178, 180, 178, 180, 184, 182, 184, 182, 178, 180, 0, 1138, 1707, 0, 0, 0, 0, 0, 0, 0, 0, 1708, 0, 0], 
[144, 144, 168, 48, 48, 48, 184, 182, 178, 180, 178, 180, 48, 48, 48, 184, 182, 184, 182, 48, 48, 48, 48, 184, 182, 48, 72, 1707, 0, 0, 0, 0, 0, 0, 0, 0, 1708, 0, 0], 
[144, 144, 146, 180, 48, 48, 48, 48, 184, 182, 184, 182, 178, 180, 178, 180, 48, 48, 178, 164, 164, 164, 180, 48, 178, 180, 72, 1715, 1717, 1717, 1717, 1717, 1717, 1717, 1717, 1717, 1716, 82, 68], 
[144, 144, 144, 146, 164, 164, 164, 180, 48, 48, 48, 48, 184, 182, 184, 182, 48, 178, 145, 144, 144, 144, 146, 180, 184, 182, 50, 68, 68, 68, 68, 68, 68, 68, 68, 68, 68, 49, 178], 
[144, 144, 144, 144, 144, 144, 144, 146, 164, 164, 164, 164, 164, 164, 164, 164, 164, 145, 144, 144, 144, 144, 144, 168, 48, 48, 178, 164, 164, 164, 164, 164, 164, 164, 164, 164, 164, 164, 145], 
[144, 144, 144, 144, 144, 144, 144, 144, 144, 144, 144, 144, 144, 144, 144, 144, 144, 144, 144, 144, 144, 144, 144, 146, 164, 164, 145, 144, 144, 144, 144, 144, 144, 144, 144, 144, 144, 144, 144], 
[144, 144, 144, 144, 144, 144, 144, 144, 144, 144, 144, 144, 144, 144, 144, 144, 144, 144, 144, 144, 144, 144, 144, 144, 144, 144, 144, 144, 144, 144, 144, 144, 144, 144, 144, 144, 144, 144, 144], 
[172, 172, 172, 172, 172, 172, 172, 172, 172, 172, 172, 172, 172, 172, 172, 172, 172, 172, 172, 172, 172, 172, 172, 172, 172, 172, 172, 172, 172, 172, 172, 172, 172, 172, 172, 172, 172, 172, 172]], 

[[0, 0, 1512, 1513, 0, 0, 0, 0, 0, 0, 0, 0, 0, 0, 0, 0, 0, 0, 0, 0, 0, 0, 1514, 1515, 1504, 1505, 0, 0, 0, 0, 0, 0, 0, 0, 0, 0, 0, 0, 0], 
[0, 0, 1504, 1505, 0, 0, 0, 0, 0, 0, 0, 0, 0, 0, 0, 0, 0, 0, 0, 0, 0, 0, 0, 0, 1512, 1513, 0, 0, 0, 0, 0, 0, 0, 0, 0, 0, 0, 0, 0], 
[0, 0, 1512, 1513, 0, 0, 0, 0, 0, 0, 0, 0, 0, 0, 0, 0, 0, 0, 0, 0, 0, 0, 0, 0, 0, 0, 0, 0, 0, 0, 0, 0, 0, 0, 0, 0, 0, 0, 0], 
[0, 0, 0, 1504, 1505, 0, 0, 0, 0, 0, 0, 0, 0, 0, 0, 0, 0, 0, 0, 0, 0, 0, 0, 0, 0, 0, 0, 0, 0, 0, 0, 0, 0, 0, 0, 0, 0, 0, 0], 
[0, 0, 0, 1512, 1513, 0, 0, 0, 0, 0, 0, 0, 0, 0, 0, 0, 0, 0, 0, 0, 0, 0, 0, 0, 0, 0, 0, 0, 0, 0, 0, 0, 0, 0, 0, 0, 0, 0, 0], 
[0, 0, 0, 0, 1504, 1505, 0, 0, 0, 0, 0, 0, 0, 0, 0, 0, 0, 0, 0, 0, 0, 0, 0, 0, 0, 0, 0, 0, 0, 0, 0, 0, 0, 0, 0, 0, 0, 0, 0], 
[0, 0, 0, 0, 1512, 1513, 0, 0, 0, 0, 0, 0, 0, 0, 0, 0, 0, 0, 0, 0, 0, 0, 0, 0, 0, 0, 0, 0, 0, 0, 0, 0, 0, 0, 0, 0, 0, 0, 0], 
[0, 0, 0, 1506, 1507, 0, 0, 0, 0, 0, 0, 0, 0, 0, 0, 0, 0, 0, 0, 0, 0, 0, 0, 0, 0, 0, 0, 0, 0, 0, 3296, 0, 0, 0, 0, 0, 0, 3302, 0], 
[0, 0, 0, 1514, 1515, 0, 0, 0, 0, 0, 0, 0, 0, 0, 0, 0, 0, 0, 0, 0, 0, 0, 0, 0, 0, 0, 0, 0, 0, 0, 0, 0, 0, 0, 0, 0, 0, 0, 0], 
[0, 0, 1504, 1505, 0, 0, 0, 0, 0, 0, 0, 0, 0, 0, 0, 0, 0, 0, 0, 0, 0, 0, 0, 0, 0, 0, 0, 0, 0, 0, 0, 0, 0, 0, 0, 0, 0, 0, 0], 
[0, 0, 1512, 1513, 0, 0, 0, 0, 0, 0, 0, 0, 0, 0, 0, 0, 0, 0, 0, 0, 0, 0, 0, 0, 0, 0, 0, 0, 0, 0, 0, 0, 0, 0, 0, 0, 0, 0, 0], 
[0, 0, 1506, 1507, 0, 0, 0, 0, 0, 0, 0, 0, 0, 0, 0, 0, 0, 0, 0, 0, 0, 0, 0, 0, 0, 0, 0, 0, 0, 0, 0, 0, 0, 0, 0, 0, 0, 0, 0], 
[0, 0, 1514, 1515, 0, 0, 0, 0, 0, 0, 0, 0, 0, 0, 0, 0, 0, 0, 0, 0, 0, 0, 0, 0, 1504, 1505, 0, 0, 0, 0, 0, 0, 0, 0, 0, 0, 0, 0, 0], 
[0, 0, 1504, 1505, 0, 0, 0, 0, 0, 0, 0, 0, 0, 0, 0, 0, 0, 0, 0, 0, 0, 0, 0, 0, 1512, 1513, 0, 0, 0, 0, 0, 0, 0, 0, 0, 0, 0, 804, 805], 
[0, 0, 1512, 1513, 0, 0, 0, 0, 0, 0, 0, 0, 0, 0, 0, 0, 0, 0, 0, 0, 0, 0, 0, 0, 0, 0, 0, 0, 0, 0, 0, 0, 0, 0, 0, 0, 0, 0, 0], 
[0, 0, 0, 0, 1506, 1507, 0, 0, 0, 0, 0, 1506, 1507, 1506, 1507, 0, 0, 0, 0, 1504, 1505, 1506, 1507, 0, 0, 1504, 1505, 0, 0, 0, 0, 0, 0, 0, 0, 0, 0, 0, 0], 
[0, 0, 0, 0, 1514, 1515, 1504, 1505, 0, 0, 0, 1514, 1515, 1514, 1515, 1504, 1505, 1506, 1507, 1512, 1513, 1514, 1515, 1506, 1507, 1512, 1513, 0, 0, 0, 0, 0, 0, 0, 0, 0, 0, 0, 0], 
[0, 0, 0, 0, 0, 0, 1512, 1513, 1504, 1505, 1506, 1507, 0, 0, 0, 1512, 1513, 1514, 1515, 0, 0, 0, 0, 1514, 1515, 0, 0, 0, 0, 0, 0, 0, 0, 0, 0, 0, 0, 0, 0], 
[0, 0, 0, 0, 0, 0, 0, 0, 1512, 1513, 1514, 1515, 1504, 1505, 1506, 1507, 0, 0, 0, 0, 0, 0, 0, 0, 1504, 1505, 0, 0, 0, 0, 0, 0, 0, 0, 0, 0, 0, 0, 0], 
[0, 0, 0, 0, 0, 0, 0, 0, 0, 0, 0, 0, 1512, 1513, 1514, 1515, 0, 0, 0, 0, 0, 0, 0, 0, 1512, 1513, 0, 0, 0, 0, 0, 0, 0, 0, 0, 0, 0, 0, 0], 
[0, 0, 0, 0, 0, 0, 0, 0, 0, 0, 0, 0, 0, 0, 0, 0, 0, 0, 0, 0, 0, 0, 0, 0, 0, 0, 0, 0, 0, 0, 0, 0, 0, 0, 0, 0, 0, 0, 0], 
[0, 0, 0, 0, 0, 0, 0, 0, 0, 0, 0, 0, 0, 0, 0, 0, 0, 0, 0, 0, 0, 0, 0, 0, 0, 0, 0, 0, 0, 0, 0, 0, 0, 0, 0, 0, 0, 0, 0], 
[0, 0, 0, 0, 0, 0, 0, 0, 0, 0, 0, 0, 0, 0, 0, 0, 0, 0, 0, 0, 0, 0, 0, 0, 0, 0, 0, 0, 0, 0, 0, 0, 0, 0, 0, 0, 0, 0, 0], 
[0, 0, 0, 0, 0, 0, 0, 0, 0, 0, 0, 0, 0, 0, 0, 0, 0, 0, 0, 0, 0, 0, 0, 0, 0, 0, 0, 0, 0, 0, 0, 0, 0, 0, 0, 0, 0, 0, 0]]]
}
}
