{
	"Map": {
		"id": 30,
		"map_display_x": 0,
		"map_display_y": 0,
		"width": 20,
		"height": 15,
		"xsize": 20,
		"ysize": 15,
		"zsize": 3,
		"Name" : "Natural Park Pavillion",
		"Parent" : "Natural Park",
		"Tileset" : "Interior general",
		"BattleBack" : "",
		"Autoplay_bgm" : false,
		"BGM" : "",
		"Autoplay_bgs" : false,
		"BGS" : "",
		"Encounter_list" : [],
		"Encounter_step" : 30,
		"table": [[[2184, 2184, 2185, 2186, 2184, 2184, 2184, 2189, 2190, 2184, 2184, 542, 542, 542, 542, 542, 542, 542, 542, 542], 
[2192, 2192, 2193, 2194, 2192, 2192, 2192, 2197, 2198, 2192, 2192, 542, 542, 542, 542, 542, 542, 542, 542, 542], 
[2221, 2221, 2221, 2221, 2221, 2221, 2221, 2221, 2221, 2221, 2221, 542, 542, 542, 542, 542, 542, 542, 542, 542], 
[2221, 2212, 2212, 2212, 2212, 2212, 2212, 2212, 2212, 2212, 2212, 542, 542, 542, 542, 542, 542, 542, 542, 542], 
[2221, 2212, 1195, 1196, 1196, 1196, 1196, 1196, 1197, 2212, 2212, 542, 542, 542, 542, 542, 542, 542, 542, 542], 
[2221, 2212, 1203, 1204, 1204, 1204, 1204, 1204, 1205, 2212, 2212, 542, 542, 542, 542, 542, 542, 542, 542, 542], 
[2221, 2212, 1203, 1204, 1204, 1204, 1204, 1204, 1205, 2212, 2212, 542, 542, 542, 542, 542, 542, 542, 542, 542], 
[2221, 2212, 1211, 1212, 1212, 1212, 1212, 1212, 1213, 2212, 2212, 542, 542, 542, 542, 542, 542, 542, 542, 542], 
[2221, 2212, 2212, 2212, 2212, 2212, 2212, 2212, 2212, 2212, 2212, 542, 542, 542, 542, 542, 542, 542, 542, 542], 
[542, 542, 542, 542, 542, 542, 542, 542, 542, 542, 542, 542, 542, 542, 542, 542, 542, 542, 542, 542], 
[542, 542, 542, 542, 542, 542, 542, 542, 542, 542, 542, 542, 542, 542, 542, 542, 542, 542, 542, 542], 
[542, 542, 542, 542, 542, 542, 542, 542, 542, 542, 542, 542, 542, 542, 542, 542, 542, 542, 542, 542], 
[542, 542, 542, 542, 542, 542, 542, 542, 542, 542, 542, 542, 542, 542, 542, 542, 542, 542, 542, 542], 
[542, 542, 542, 542, 542, 542, 542, 542, 542, 542, 542, 542, 542, 542, 542, 542, 542, 542, 542, 542], 
[542, 542, 542, 542, 542, 542, 542, 542, 542, 542, 542, 542, 542, 542, 542, 542, 542, 542, 542, 542]], 

[[0, 0, 0, 0, 0, 0, 0, 0, 0, 0, 0, 0, 0, 0, 0, 0, 0, 0, 0, 0], 
[1770, 0, 2008, 0, 0, 0, 0, 0, 2008, 0, 1770, 0, 0, 0, 0, 0, 0, 0, 0, 0], 
[1778, 0, 2017, 2002, 2002, 2002, 2002, 2002, 2019, 0, 1778, 0, 0, 0, 0, 0, 0, 0, 0, 0], 
[0, 0, 2025, 2026, 2026, 2026, 2026, 2026, 2027, 0, 0, 0, 0, 0, 0, 0, 0, 0, 0, 0], 
[0, 0, 0, 0, 0, 0, 0, 0, 0, 0, 0, 0, 0, 0, 0, 0, 0, 0, 0, 0], 
[0, 0, 0, 0, 0, 0, 0, 0, 0, 0, 0, 0, 0, 0, 0, 0, 0, 0, 0, 0], 
[0, 0, 0, 0, 0, 0, 0, 0, 0, 0, 0, 0, 0, 0, 0, 0, 0, 0, 0, 0], 
[1770, 0, 0, 0, 0, 0, 0, 0, 0, 0, 1770, 0, 0, 0, 0, 0, 0, 0, 0, 0], 
[1778, 0, 0, 0, 1245, 1246, 1247, 0, 0, 0, 1778, 0, 0, 0, 0, 0, 0, 0, 0, 0], 
[0, 0, 0, 0, 1253, 1254, 1255, 0, 0, 0, 0, 0, 0, 0, 0, 0, 0, 0, 0, 0], 
[0, 0, 0, 0, 0, 0, 0, 0, 0, 0, 0, 0, 0, 0, 0, 0, 0, 0, 0, 0], 
[0, 0, 0, 0, 0, 0, 0, 0, 0, 0, 0, 0, 0, 0, 0, 0, 0, 0, 0, 0], 
[0, 0, 0, 0, 0, 0, 0, 0, 0, 0, 0, 0, 0, 0, 0, 0, 0, 0, 0, 0], 
[0, 0, 0, 0, 0, 0, 0, 0, 0, 0, 0, 0, 0, 0, 0, 0, 0, 0, 0, 0], 
[0, 0, 0, 0, 0, 0, 0, 0, 0, 0, 0, 0, 0, 0, 0, 0, 0, 0, 0, 0]], 

[[0, 0, 0, 0, 0, 0, 0, 0, 0, 0, 0, 0, 0, 0, 0, 0, 0, 0, 0, 0], 
[0, 0, 0, 0, 0, 0, 0, 0, 0, 0, 0, 0, 0, 0, 0, 0, 0, 0, 0, 0], 
[0, 0, 0, 0, 0, 0, 0, 0, 0, 0, 0, 0, 0, 0, 0, 0, 0, 0, 0, 0], 
[0, 0, 0, 0, 0, 0, 0, 0, 0, 0, 0, 0, 0, 0, 0, 0, 0, 0, 0, 0], 
[0, 0, 0, 0, 0, 0, 0, 0, 0, 0, 0, 0, 0, 0, 0, 0, 0, 0, 0, 0], 
[0, 0, 0, 0, 0, 0, 0, 0, 0, 0, 0, 0, 0, 0, 0, 0, 0, 0, 0, 0], 
[0, 0, 0, 0, 0, 0, 0, 0, 0, 0, 0, 0, 0, 0, 0, 0, 0, 0, 0, 0], 
[0, 0, 0, 0, 0, 0, 0, 0, 0, 0, 0, 0, 0, 0, 0, 0, 0, 0, 0, 0], 
[0, 0, 0, 0, 0, 0, 0, 0, 0, 0, 0, 0, 0, 0, 0, 0, 0, 0, 0, 0], 
[0, 0, 0, 0, 0, 0, 0, 0, 0, 0, 0, 0, 0, 0, 0, 0, 0, 0, 0, 0], 
[0, 0, 0, 0, 0, 0, 0, 0, 0, 0, 0, 0, 0, 0, 0, 0, 0, 0, 0, 0], 
[0, 0, 0, 0, 0, 0, 0, 0, 0, 0, 0, 0, 0, 0, 0, 0, 0, 0, 0, 0], 
[0, 0, 0, 0, 0, 0, 0, 0, 0, 0, 0, 0, 0, 0, 0, 0, 0, 0, 0, 0], 
[0, 0, 0, 0, 0, 0, 0, 0, 0, 0, 0, 0, 0, 0, 0, 0, 0, 0, 0, 0], 
[0, 0, 0, 0, 0, 0, 0, 0, 0, 0, 0, 0, 0, 0, 0, 0, 0, 0, 0, 0]]]
}
}
