{
	"Map": {
		"id": 8,
		"map_display_x": 0,
		"map_display_y": 0,
		"width": 20,
		"height": 15,
		"xsize": 20,
		"ysize": 15,
		"zsize": 3,
		"Name" : "Daisy's house",
		"Parent" : "Lappet Town",
		"Tileset" : "Interior general",
		"BattleBack" : "",
		"Autoplay_bgm" : true,
		"BGM" : "Mom Theme",
		"Autoplay_bgs" : false,
		"BGS" : "",
		"Encounter_list" : [],
		"Encounter_step" : 30,
		"table": [[[416, 416, 416, 416, 416, 416, 416, 416, 416, 416, 416, 416, 416, 542, 542, 542, 542, 542, 542, 542], 
[424, 424, 424, 424, 424, 424, 424, 424, 424, 424, 424, 424, 424, 542, 542, 542, 542, 542, 542, 542], 
[769, 769, 769, 769, 769, 769, 769, 769, 769, 769, 769, 769, 769, 542, 542, 542, 542, 542, 542, 542], 
[769, 760, 760, 760, 760, 760, 760, 760, 760, 760, 760, 760, 760, 542, 542, 542, 542, 542, 542, 542], 
[769, 760, 760, 760, 760, 760, 760, 760, 760, 760, 760, 760, 760, 542, 542, 542, 542, 542, 542, 542], 
[769, 760, 760, 760, 760, 760, 760, 760, 760, 760, 760, 760, 760, 542, 542, 542, 542, 542, 542, 542], 
[769, 760, 760, 760, 760, 760, 760, 760, 760, 760, 760, 760, 760, 542, 542, 542, 542, 542, 542, 542], 
[769, 760, 760, 760, 760, 760, 760, 760, 760, 760, 760, 760, 760, 542, 542, 542, 542, 542, 542, 542], 
[769, 760, 760, 760, 760, 760, 760, 760, 760, 760, 760, 760, 760, 542, 542, 542, 542, 542, 542, 542], 
[542, 542, 542, 542, 542, 542, 542, 542, 542, 542, 542, 542, 542, 542, 542, 542, 542, 542, 542, 542], 
[542, 542, 542, 542, 542, 542, 542, 542, 542, 542, 542, 542, 542, 542, 542, 542, 542, 542, 542, 542], 
[542, 542, 542, 542, 542, 542, 542, 542, 542, 542, 542, 542, 542, 542, 542, 542, 542, 542, 542, 542], 
[542, 542, 542, 542, 542, 542, 542, 542, 542, 542, 542, 542, 542, 542, 542, 542, 542, 542, 542, 542], 
[542, 542, 542, 542, 542, 542, 542, 542, 542, 542, 542, 542, 542, 542, 542, 542, 542, 542, 542, 542], 
[542, 542, 542, 542, 542, 542, 542, 542, 542, 542, 542, 542, 542, 542, 542, 542, 542, 542, 542, 542]], 

[[0, 0, 1530, 1531, 0, 1712, 1491, 1492, 0, 1440, 0, 1504, 1505, 0, 0, 0, 0, 0, 0, 0], 
[1569, 1570, 1538, 1539, 0, 1720, 1499, 1500, 0, 1448, 0, 1512, 1513, 0, 0, 0, 0, 0, 0, 0], 
[1577, 1578, 1546, 1547, 0, 1728, 0, 0, 0, 0, 0, 1520, 1521, 0, 0, 0, 0, 0, 0, 0], 
[0, 0, 0, 0, 1168, 1169, 1169, 1169, 1169, 1170, 0, 0, 0, 0, 0, 0, 0, 0, 0, 0], 
[0, 0, 0, 0, 1176, 1177, 1177, 1177, 1177, 1178, 0, 0, 0, 0, 0, 0, 0, 0, 0, 0], 
[0, 0, 0, 0, 1176, 1177, 1177, 1177, 1177, 1178, 0, 0, 0, 0, 0, 0, 0, 0, 0, 0], 
[0, 0, 0, 0, 1184, 1185, 1185, 1185, 1185, 1186, 0, 0, 0, 0, 0, 0, 0, 0, 0, 0], 
[1770, 0, 0, 0, 0, 0, 0, 0, 0, 0, 0, 0, 1770, 0, 0, 0, 0, 0, 0, 0], 
[1778, 0, 1245, 1246, 1247, 0, 0, 0, 0, 0, 0, 0, 1778, 0, 0, 0, 0, 0, 0, 0], 
[0, 0, 1253, 1254, 1255, 0, 0, 0, 0, 0, 0, 0, 0, 0, 0, 0, 0, 0, 0, 0], 
[0, 0, 0, 0, 0, 0, 0, 0, 0, 0, 0, 0, 0, 0, 0, 0, 0, 0, 0, 0], 
[0, 0, 0, 0, 0, 0, 0, 0, 0, 0, 0, 0, 0, 0, 0, 0, 0, 0, 0, 0], 
[0, 0, 0, 0, 0, 0, 0, 0, 0, 0, 0, 0, 0, 0, 0, 0, 0, 0, 0, 0], 
[0, 0, 0, 0, 0, 0, 0, 0, 0, 0, 0, 0, 0, 0, 0, 0, 0, 0, 0, 0], 
[0, 0, 0, 0, 0, 0, 0, 0, 0, 0, 0, 0, 0, 0, 0, 0, 0, 0, 0, 0]], 

[[0, 0, 0, 0, 0, 0, 0, 0, 0, 0, 0, 0, 0, 0, 0, 0, 0, 0, 0, 0], 
[0, 0, 0, 0, 0, 0, 0, 0, 0, 0, 0, 0, 0, 0, 0, 0, 0, 0, 0, 0], 
[0, 0, 0, 0, 0, 0, 0, 0, 0, 0, 0, 0, 0, 0, 0, 0, 0, 0, 0, 0], 
[0, 0, 0, 0, 0, 0, 0, 0, 0, 0, 0, 0, 0, 0, 0, 0, 0, 0, 0, 0], 
[0, 0, 0, 0, 0, 1674, 2083, 2085, 1675, 0, 0, 0, 0, 0, 0, 0, 0, 0, 0, 0], 
[0, 0, 0, 0, 0, 1674, 2091, 2093, 1675, 0, 0, 0, 0, 0, 0, 0, 0, 0, 0, 0], 
[0, 0, 0, 0, 0, 0, 0, 0, 0, 0, 0, 0, 0, 0, 0, 0, 0, 0, 0, 0], 
[0, 0, 0, 0, 0, 0, 0, 0, 0, 0, 0, 0, 0, 0, 0, 0, 0, 0, 0, 0], 
[0, 0, 0, 0, 0, 0, 0, 0, 0, 0, 0, 0, 0, 0, 0, 0, 0, 0, 0, 0], 
[0, 0, 0, 0, 0, 0, 0, 0, 0, 0, 0, 0, 0, 0, 0, 0, 0, 0, 0, 0], 
[0, 0, 0, 0, 0, 0, 0, 0, 0, 0, 0, 0, 0, 0, 0, 0, 0, 0, 0, 0], 
[0, 0, 0, 0, 0, 0, 0, 0, 0, 0, 0, 0, 0, 0, 0, 0, 0, 0, 0, 0], 
[0, 0, 0, 0, 0, 0, 0, 0, 0, 0, 0, 0, 0, 0, 0, 0, 0, 0, 0, 0], 
[0, 0, 0, 0, 0, 0, 0, 0, 0, 0, 0, 0, 0, 0, 0, 0, 0, 0, 0, 0], 
[0, 0, 0, 0, 0, 0, 0, 0, 0, 0, 0, 0, 0, 0, 0, 0, 0, 0, 0, 0]]]
}
}
