{
	"Map": {
		"id": 37,
		"map_display_x": 0,
		"map_display_y": 0,
		"width": 20,
		"height": 15,
		"xsize": 20,
		"ysize": 15,
		"zsize": 3,
		"Name" : "Pokémon League",
		"Parent" : "Ingido Plateau",
		"Tileset" : "Gyms interior",
		"BattleBack" : "",
		"Autoplay_bgm" : true,
		"BGM" : "PkmRS-BTower",
		"Autoplay_bgs" : false,
		"BGS" : "",
		"Encounter_list" : [],
		"Encounter_step" : 30,
		"table": [[[979, 979, 979, 979, 979, 979, 979, 979, 979, 979, 979, 979, 979, 384, 384, 384, 384, 384, 384, 384], 
[985, 986, 985, 986, 985, 987, 990, 989, 986, 985, 986, 985, 986, 384, 384, 384, 384, 384, 384, 384], 
[993, 994, 993, 994, 993, 995, 998, 997, 994, 993, 994, 993, 994, 384, 384, 384, 384, 384, 384, 384], 
[1097, 1097, 1097, 1097, 1097, 1097, 1097, 1097, 1097, 1097, 1097, 1097, 1097, 384, 384, 384, 384, 384, 384, 384], 
[1097, 1078, 1097, 1098, 1069, 1070, 1070, 1070, 1071, 1078, 1097, 1098, 1078, 384, 384, 384, 384, 384, 384, 384], 
[1097, 1078, 1078, 1078, 1077, 1065, 1066, 1067, 1079, 1078, 1078, 1078, 1078, 384, 384, 384, 384, 384, 384, 384], 
[1097, 1078, 1097, 1098, 1072, 1073, 1074, 1075, 1076, 1078, 1097, 1098, 1078, 384, 384, 384, 384, 384, 384, 384], 
[1097, 1078, 1105, 1106, 1080, 1081, 1082, 1083, 1084, 1078, 1105, 1106, 1078, 384, 384, 384, 384, 384, 384, 384], 
[1097, 1078, 1078, 1078, 1077, 1089, 1090, 1091, 1079, 1078, 1078, 1078, 1078, 384, 384, 384, 384, 384, 384, 384], 
[1097, 1078, 1097, 1098, 1085, 1086, 1086, 1086, 1087, 1078, 1097, 1098, 1078, 384, 384, 384, 384, 384, 384, 384], 
[977, 977, 977, 977, 977, 977, 977, 977, 977, 977, 977, 977, 977, 384, 384, 384, 384, 384, 384, 384], 
[985, 986, 985, 986, 985, 1078, 1078, 1078, 986, 985, 986, 985, 986, 384, 384, 384, 384, 384, 384, 384], 
[993, 994, 993, 994, 993, 1097, 1098, 1078, 994, 993, 994, 993, 994, 384, 384, 384, 384, 384, 384, 384], 
[384, 384, 384, 384, 384, 384, 384, 384, 384, 384, 384, 384, 384, 384, 384, 384, 384, 384, 384, 384], 
[384, 384, 384, 384, 384, 384, 384, 384, 384, 384, 384, 384, 384, 384, 384, 384, 384, 384, 384, 384]], 

[[0, 0, 0, 0, 0, 0, 0, 0, 0, 0, 0, 0, 0, 0, 0, 0, 0, 0, 0, 0], 
[0, 0, 0, 0, 0, 0, 991, 0, 0, 0, 0, 0, 0, 0, 0, 0, 0, 0, 0, 0], 
[0, 0, 1094, 0, 0, 0, 0, 0, 0, 0, 1094, 0, 0, 0, 0, 0, 0, 0, 0, 0], 
[1093, 0, 1102, 0, 0, 1003, 0, 1005, 0, 0, 1102, 0, 1093, 0, 0, 0, 0, 0, 0, 0], 
[1093, 0, 1110, 0, 0, 0, 0, 0, 0, 0, 1110, 0, 1093, 0, 0, 0, 0, 0, 0, 0], 
[1093, 0, 1103, 0, 0, 0, 0, 0, 0, 0, 1103, 0, 1093, 0, 0, 0, 0, 0, 0, 0], 
[1093, 0, 1111, 0, 0, 0, 0, 0, 0, 0, 1111, 0, 1093, 0, 0, 0, 0, 0, 0, 0], 
[1093, 0, 1095, 0, 0, 0, 0, 0, 0, 0, 1095, 0, 1093, 0, 0, 0, 0, 0, 0, 0], 
[1093, 0, 1103, 0, 0, 0, 0, 0, 0, 0, 1103, 0, 1093, 0, 0, 0, 0, 0, 0, 0], 
[1093, 0, 1111, 0, 0, 0, 0, 0, 0, 0, 1111, 0, 1093, 0, 0, 0, 0, 0, 0, 0], 
[0, 0, 0, 0, 0, 0, 0, 0, 0, 0, 0, 0, 0, 0, 0, 0, 0, 0, 0, 0], 
[0, 0, 0, 0, 0, 1000, 1001, 1002, 0, 0, 0, 0, 0, 0, 0, 0, 0, 0, 0, 0], 
[0, 0, 0, 0, 0, 1008, 0, 1010, 0, 0, 0, 0, 0, 0, 0, 0, 0, 0, 0, 0], 
[0, 0, 0, 0, 0, 0, 0, 0, 0, 0, 0, 0, 0, 0, 0, 0, 0, 0, 0, 0], 
[0, 0, 0, 0, 0, 0, 0, 0, 0, 0, 0, 0, 0, 0, 0, 0, 0, 0, 0, 0]], 

[[0, 0, 0, 0, 0, 0, 0, 0, 0, 0, 0, 0, 0, 0, 0, 0, 0, 0, 0, 0], 
[0, 0, 0, 0, 0, 0, 0, 0, 0, 0, 0, 0, 0, 0, 0, 0, 0, 0, 0, 0], 
[0, 0, 0, 0, 0, 0, 0, 0, 0, 0, 0, 0, 0, 0, 0, 0, 0, 0, 0, 0], 
[0, 0, 0, 0, 0, 0, 0, 0, 0, 0, 0, 0, 0, 0, 0, 0, 0, 0, 0, 0], 
[0, 0, 1095, 0, 0, 0, 0, 0, 0, 0, 1095, 0, 0, 0, 0, 0, 0, 0, 0, 0], 
[0, 0, 0, 0, 0, 0, 0, 0, 0, 0, 0, 0, 0, 0, 0, 0, 0, 0, 0, 0], 
[0, 0, 0, 0, 0, 0, 0, 0, 0, 0, 0, 0, 0, 0, 0, 0, 0, 0, 0, 0], 
[0, 0, 0, 0, 0, 0, 0, 0, 0, 0, 0, 0, 0, 0, 0, 0, 0, 0, 0, 0], 
[0, 0, 0, 0, 0, 0, 0, 0, 0, 0, 0, 0, 0, 0, 0, 0, 0, 0, 0, 0], 
[0, 0, 0, 0, 0, 0, 0, 0, 0, 0, 0, 0, 0, 0, 0, 0, 0, 0, 0, 0], 
[0, 0, 0, 0, 0, 0, 0, 0, 0, 0, 0, 0, 0, 0, 0, 0, 0, 0, 0, 0], 
[0, 0, 0, 0, 0, 0, 0, 0, 0, 0, 0, 0, 0, 0, 0, 0, 0, 0, 0, 0], 
[0, 0, 0, 0, 0, 0, 0, 0, 0, 0, 0, 0, 0, 0, 0, 0, 0, 0, 0, 0], 
[0, 0, 0, 0, 0, 0, 0, 0, 0, 0, 0, 0, 0, 0, 0, 0, 0, 0, 0, 0], 
[0, 0, 0, 0, 0, 0, 0, 0, 0, 0, 0, 0, 0, 0, 0, 0, 0, 0, 0, 0]]]
}
}
