{
	"Map": {
		"id": 38,
		"map_display_x": 0,
		"map_display_y": 0,
		"width": 20,
		"height": 15,
		"xsize": 20,
		"ysize": 15,
		"zsize": 3,
		"Name" : "Hall of Fame",
		"Parent" : "Ingido Plateau",
		"Tileset" : "Gyms interior",
		"BattleBack" : "",
		"Autoplay_bgm" : true,
		"BGM" : "HoF room",
		"Autoplay_bgs" : false,
		"BGS" : "",
		"Encounter_list" : [],
		"Encounter_step" : 30,
		"table": [[[1400, 1401, 1402, 1403, 1404, 1405, 1406, 1407, 1440, 1401, 1442, 384, 384, 384, 384, 384, 384, 384, 384, 384], 
[1408, 1409, 1410, 1411, 1412, 1413, 1414, 1415, 1448, 1409, 1450, 384, 384, 384, 384, 384, 384, 384, 384, 384], 
[1416, 1417, 1418, 1419, 1420, 1421, 1422, 1423, 1456, 1457, 1458, 384, 384, 384, 384, 384, 384, 384, 384, 384], 
[1424, 1425, 1439, 1427, 1428, 1429, 1430, 1431, 1439, 1465, 1466, 384, 384, 384, 384, 384, 384, 384, 384, 384], 
[1424, 1426, 1447, 1426, 1436, 1437, 1438, 1426, 1447, 1426, 1474, 384, 384, 384, 384, 384, 384, 384, 384, 384], 
[1424, 1426, 1455, 1426, 1426, 1426, 1426, 1426, 1455, 1426, 1474, 384, 384, 384, 384, 384, 384, 384, 384, 384], 
[1424, 1426, 1439, 1426, 1444, 1445, 1446, 1426, 1439, 1426, 1474, 384, 384, 384, 384, 384, 384, 384, 384, 384], 
[1424, 1426, 1447, 1426, 1452, 1453, 1454, 1426, 1447, 1426, 1474, 384, 384, 384, 384, 384, 384, 384, 384, 384], 
[1424, 1426, 1455, 1426, 1460, 1461, 1462, 1426, 1455, 1426, 1474, 384, 384, 384, 384, 384, 384, 384, 384, 384], 
[1424, 1426, 1439, 1426, 1426, 1426, 1426, 1426, 1439, 1426, 1474, 384, 384, 384, 384, 384, 384, 384, 384, 384], 
[1424, 1426, 1447, 1426, 1426, 1426, 1426, 1426, 1447, 1426, 1474, 384, 384, 384, 384, 384, 384, 384, 384, 384], 
[1432, 1426, 1455, 1426, 1426, 1426, 1426, 1426, 1455, 1426, 1482, 384, 384, 384, 384, 384, 384, 384, 384, 384], 
[384, 384, 384, 384, 1468, 1426, 1470, 384, 384, 384, 384, 384, 384, 384, 384, 384, 384, 384, 384, 384], 
[384, 384, 384, 384, 384, 384, 384, 384, 384, 384, 384, 384, 384, 384, 384, 384, 384, 384, 384, 384], 
[384, 384, 384, 384, 384, 384, 384, 384, 384, 384, 384, 384, 384, 384, 384, 384, 384, 384, 384, 384]], 

[[0, 0, 0, 0, 0, 0, 0, 0, 0, 0, 0, 0, 0, 0, 0, 0, 0, 0, 0, 0], 
[0, 0, 0, 0, 0, 0, 0, 0, 0, 0, 0, 0, 0, 0, 0, 0, 0, 0, 0, 0], 
[0, 0, 0, 0, 0, 0, 0, 0, 0, 0, 0, 0, 0, 0, 0, 0, 0, 0, 0, 0], 
[0, 0, 0, 0, 0, 0, 0, 0, 0, 0, 0, 0, 0, 0, 0, 0, 0, 0, 0, 0], 
[0, 0, 0, 0, 0, 0, 0, 0, 0, 0, 0, 0, 0, 0, 0, 0, 0, 0, 0, 0], 
[0, 0, 0, 0, 0, 0, 0, 0, 0, 0, 0, 0, 0, 0, 0, 0, 0, 0, 0, 0], 
[0, 0, 0, 0, 0, 0, 0, 0, 0, 0, 0, 0, 0, 0, 0, 0, 0, 0, 0, 0], 
[0, 0, 0, 0, 0, 0, 0, 0, 0, 0, 0, 0, 0, 0, 0, 0, 0, 0, 0, 0], 
[0, 0, 0, 0, 0, 0, 0, 0, 0, 0, 0, 0, 0, 0, 0, 0, 0, 0, 0, 0], 
[0, 0, 0, 0, 0, 0, 0, 0, 0, 0, 0, 0, 0, 0, 0, 0, 0, 0, 0, 0], 
[0, 0, 0, 0, 0, 0, 0, 0, 0, 0, 0, 0, 0, 0, 0, 0, 0, 0, 0, 0], 
[0, 0, 0, 0, 0, 0, 0, 0, 0, 0, 0, 0, 0, 0, 0, 0, 0, 0, 0, 0], 
[0, 0, 0, 0, 0, 0, 0, 0, 0, 0, 0, 0, 0, 0, 0, 0, 0, 0, 0, 0], 
[0, 0, 0, 0, 0, 0, 0, 0, 0, 0, 0, 0, 0, 0, 0, 0, 0, 0, 0, 0], 
[0, 0, 0, 0, 0, 0, 0, 0, 0, 0, 0, 0, 0, 0, 0, 0, 0, 0, 0, 0]], 

[[0, 0, 0, 0, 0, 0, 0, 0, 0, 0, 0, 0, 0, 0, 0, 0, 0, 0, 0, 0], 
[0, 0, 0, 0, 0, 0, 0, 0, 0, 0, 0, 0, 0, 0, 0, 0, 0, 0, 0, 0], 
[0, 0, 0, 0, 0, 0, 0, 0, 0, 0, 0, 0, 0, 0, 0, 0, 0, 0, 0, 0], 
[0, 0, 0, 0, 0, 0, 0, 0, 0, 0, 0, 0, 0, 0, 0, 0, 0, 0, 0, 0], 
[0, 0, 0, 0, 0, 0, 0, 0, 0, 0, 0, 0, 0, 0, 0, 0, 0, 0, 0, 0], 
[0, 0, 0, 0, 0, 0, 0, 0, 0, 0, 0, 0, 0, 0, 0, 0, 0, 0, 0, 0], 
[0, 0, 0, 0, 0, 0, 0, 0, 0, 0, 0, 0, 0, 0, 0, 0, 0, 0, 0, 0], 
[0, 0, 0, 0, 0, 0, 0, 0, 0, 0, 0, 0, 0, 0, 0, 0, 0, 0, 0, 0], 
[0, 0, 0, 0, 0, 0, 0, 0, 0, 0, 0, 0, 0, 0, 0, 0, 0, 0, 0, 0], 
[0, 0, 0, 0, 0, 0, 0, 0, 0, 0, 0, 0, 0, 0, 0, 0, 0, 0, 0, 0], 
[0, 0, 0, 0, 0, 0, 0, 0, 0, 0, 0, 0, 0, 0, 0, 0, 0, 0, 0, 0], 
[0, 0, 0, 0, 0, 0, 0, 0, 0, 0, 0, 0, 0, 0, 0, 0, 0, 0, 0, 0], 
[0, 0, 0, 0, 0, 0, 0, 0, 0, 0, 0, 0, 0, 0, 0, 0, 0, 0, 0, 0], 
[0, 0, 0, 0, 0, 0, 0, 0, 0, 0, 0, 0, 0, 0, 0, 0, 0, 0, 0, 0], 
[0, 0, 0, 0, 0, 0, 0, 0, 0, 0, 0, 0, 0, 0, 0, 0, 0, 0, 0, 0]]]
}
}
