{
	"Map": {
		"id": 5,
		"map_display_x": 0,
		"map_display_y": 0,
		"width": 36,
		"height": 24,
		"xsize": 36,
		"ysize": 24,
		"zsize": 3,
		"Name" : "Route 1",
		"Parent" : "",
		"Tileset" : "Outside",
		"BattleBack" : "",
		"Autoplay_bgm" : true,
		"BGM" : "route",
		"Autoplay_bgs" : false,
		"BGS" : "",
		"Encounter_list" : [],
		"Encounter_step" : 30,
		"table": [[[808, 809, 808, 809, 808, 809, 808, 809, 808, 809, 808, 809, 808, 809, 808, 809, 808, 811, 545, 546, 546, 547, 810, 809, 808, 809, 808, 809, 808, 809, 808, 809, 808, 809, 808, 809], 
[800, 801, 800, 801, 800, 801, 800, 801, 800, 801, 800, 801, 800, 801, 800, 801, 800, 803, 545, 546, 546, 547, 802, 801, 800, 801, 800, 801, 800, 801, 800, 801, 800, 801, 800, 801], 
[808, 809, 808, 809, 808, 809, 808, 809, 808, 809, 808, 809, 808, 809, 808, 809, 808, 811, 545, 546, 546, 547, 810, 809, 808, 809, 808, 809, 808, 809, 808, 809, 808, 809, 808, 809], 
[800, 801, 800, 801, 800, 801, 800, 801, 800, 803, 818, 819, 818, 819, 818, 819, 818, 819, 545, 546, 546, 547, 818, 819, 818, 819, 818, 819, 802, 801, 800, 801, 800, 801, 800, 801], 
[808, 809, 808, 809, 808, 809, 808, 809, 808, 811, 385, 385, 385, 385, 385, 387, 390, 390, 545, 546, 546, 547, 390, 390, 390, 390, 390, 390, 810, 809, 808, 809, 808, 809, 808, 809], 
[800, 801, 800, 801, 800, 801, 800, 803, 818, 819, 385, 385, 385, 385, 385, 388, 390, 390, 545, 546, 546, 547, 390, 390, 390, 390, 390, 390, 802, 801, 800, 801, 800, 801, 800, 801], 
[808, 809, 808, 809, 808, 809, 808, 811, 274, 276, 385, 385, 386, 386, 385, 385, 390, 390, 545, 546, 546, 547, 390, 390, 390, 390, 390, 390, 810, 809, 808, 809, 808, 809, 808, 809], 
[800, 801, 800, 801, 800, 801, 800, 803, 256, 264, 387, 385, 388, 385, 282, 385, 390, 390, 545, 546, 546, 556, 538, 538, 538, 539, 390, 390, 802, 801, 800, 801, 800, 801, 800, 801], 
[808, 809, 808, 809, 808, 809, 808, 811, 280, 278, 388, 386, 387, 385, 284, 389, 390, 390, 553, 554, 554, 554, 554, 542, 546, 547, 390, 390, 810, 809, 808, 809, 808, 809, 808, 809], 
[800, 801, 800, 801, 800, 801, 800, 803, 385, 385, 385, 387, 385, 385, 385, 385, 390, 390, 390, 390, 390, 390, 390, 545, 546, 547, 390, 390, 802, 801, 800, 801, 800, 801, 800, 801], 
[808, 809, 808, 809, 808, 809, 808, 811, 810, 811, 385, 385, 387, 385, 390, 390, 390, 390, 390, 810, 811, 810, 811, 545, 546, 547, 810, 811, 810, 809, 808, 809, 808, 809, 808, 809], 
[800, 801, 800, 801, 800, 801, 800, 801, 800, 803, 386, 385, 386, 389, 388, 390, 390, 390, 390, 818, 819, 818, 819, 545, 546, 547, 818, 819, 802, 801, 800, 801, 800, 801, 800, 801], 
[808, 809, 808, 809, 808, 809, 808, 809, 808, 811, 387, 385, 388, 387, 385, 386, 390, 390, 390, 390, 385, 386, 388, 545, 546, 547, 390, 390, 810, 809, 808, 809, 808, 809, 808, 809], 
[800, 801, 800, 801, 800, 801, 800, 803, 818, 819, 388, 386, 387, 386, 386, 388, 389, 386, 387, 386, 385, 387, 385, 545, 546, 547, 390, 390, 802, 801, 800, 801, 800, 801, 800, 801], 
[808, 809, 808, 809, 808, 809, 808, 811, 386, 387, 389, 385, 389, 386, 387, 385, 388, 537, 538, 538, 538, 538, 538, 558, 546, 547, 390, 390, 810, 809, 808, 809, 808, 809, 808, 809], 
[800, 801, 800, 801, 800, 801, 800, 803, 388, 388, 389, 387, 387, 386, 387, 386, 388, 545, 546, 546, 540, 554, 554, 554, 554, 555, 390, 390, 802, 801, 800, 801, 800, 801, 800, 801], 
[808, 809, 808, 809, 808, 809, 808, 811, 386, 385, 386, 389, 388, 385, 389, 385, 387, 545, 546, 546, 547, 385, 388, 387, 385, 388, 390, 390, 810, 809, 808, 809, 808, 809, 808, 809], 
[800, 801, 800, 801, 800, 801, 800, 803, 387, 388, 385, 387, 387, 386, 386, 386, 388, 545, 546, 546, 547, 387, 385, 389, 386, 390, 390, 390, 802, 801, 800, 801, 800, 801, 800, 801], 
[808, 809, 808, 809, 808, 809, 808, 811, 386, 386, 389, 388, 386, 389, 386, 386, 385, 553, 554, 554, 555, 385, 390, 390, 390, 390, 390, 390, 810, 809, 808, 809, 808, 809, 808, 809], 
[800, 801, 800, 801, 800, 801, 800, 803, 388, 387, 385, 386, 387, 385, 386, 385, 387, 385, 386, 385, 390, 390, 390, 390, 390, 390, 390, 390, 802, 801, 800, 801, 800, 801, 800, 801], 
[808, 809, 808, 809, 808, 809, 808, 811, 385, 386, 387, 388, 385, 386, 387, 385, 388, 385, 385, 388, 385, 385, 385, 386, 385, 385, 385, 388, 810, 809, 808, 809, 808, 809, 808, 809], 
[800, 801, 800, 801, 800, 801, 800, 803, 385, 387, 385, 386, 387, 389, 388, 385, 387, 386, 385, 389, 386, 388, 387, 385, 388, 386, 387, 386, 802, 801, 800, 801, 800, 801, 800, 801], 
[808, 809, 808, 809, 808, 809, 808, 811, 810, 811, 810, 811, 810, 811, 810, 811, 810, 811, 386, 385, 810, 811, 810, 811, 810, 811, 810, 811, 810, 809, 808, 809, 808, 809, 808, 809], 
[800, 801, 800, 801, 800, 801, 800, 801, 800, 801, 800, 801, 800, 801, 800, 801, 800, 803, 387, 388, 802, 801, 800, 801, 800, 801, 800, 801, 800, 801, 800, 801, 800, 801, 800, 801]], 

[[0, 0, 0, 0, 0, 0, 0, 0, 0, 0, 0, 0, 0, 0, 0, 0, 0, 0, 0, 0, 0, 0, 0, 0, 0, 0, 0, 0, 0, 0, 0, 0, 0, 0, 0, 0], 
[0, 0, 0, 0, 0, 0, 0, 0, 0, 0, 0, 0, 0, 0, 0, 0, 0, 0, 0, 0, 0, 0, 0, 0, 0, 0, 0, 0, 0, 0, 0, 0, 0, 0, 0, 0], 
[0, 0, 0, 0, 0, 0, 0, 0, 0, 0, 0, 0, 0, 0, 0, 0, 0, 0, 0, 0, 0, 0, 0, 0, 0, 0, 0, 0, 0, 0, 0, 0, 0, 0, 0, 0], 
[0, 0, 0, 0, 0, 0, 0, 0, 0, 0, 1784, 1785, 1786, 1787, 1788, 0, 0, 0, 0, 0, 0, 0, 0, 0, 0, 0, 0, 0, 0, 0, 0, 0, 0, 0, 0, 0], 
[0, 0, 0, 0, 0, 0, 0, 0, 0, 0, 1792, 1793, 1794, 1795, 1796, 1656, 0, 0, 0, 0, 0, 0, 0, 0, 0, 0, 0, 0, 0, 0, 0, 0, 0, 0, 0, 0], 
[0, 0, 0, 0, 0, 0, 0, 0, 0, 0, 1800, 1801, 1802, 1803, 1804, 1664, 0, 0, 0, 0, 0, 0, 0, 0, 0, 0, 0, 0, 0, 0, 0, 0, 0, 0, 0, 0], 
[0, 0, 0, 0, 0, 0, 0, 0, 0, 0, 1808, 1809, 1810, 1811, 1812, 1664, 0, 0, 0, 0, 0, 0, 0, 0, 0, 0, 0, 0, 0, 0, 0, 0, 0, 0, 0, 0], 
[0, 0, 0, 0, 0, 0, 0, 0, 0, 0, 0, 0, 0, 0, 0, 1664, 0, 0, 0, 0, 0, 0, 0, 0, 0, 0, 0, 0, 0, 0, 0, 0, 0, 0, 0, 0], 
[0, 0, 0, 0, 0, 0, 0, 0, 0, 0, 0, 0, 0, 0, 0, 1664, 0, 0, 0, 0, 0, 0, 0, 0, 0, 0, 0, 0, 0, 0, 0, 0, 0, 0, 0, 0], 
[0, 0, 0, 0, 0, 0, 0, 0, 1680, 1681, 1682, 0, 0, 1680, 1681, 1679, 0, 0, 0, 0, 0, 0, 0, 0, 0, 0, 0, 0, 0, 0, 0, 0, 0, 0, 0, 0], 
[0, 0, 0, 0, 0, 0, 0, 0, 0, 0, 0, 0, 0, 0, 0, 0, 0, 0, 0, 0, 0, 0, 0, 1194, 1212, 1198, 0, 0, 0, 0, 0, 0, 0, 0, 0, 0], 
[0, 0, 0, 0, 0, 0, 0, 0, 0, 0, 0, 0, 0, 0, 0, 0, 0, 0, 0, 0, 0, 0, 0, 0, 0, 0, 0, 0, 0, 0, 0, 0, 0, 0, 0, 0], 
[0, 0, 0, 0, 0, 0, 0, 0, 0, 0, 0, 0, 0, 0, 0, 0, 0, 0, 0, 0, 0, 0, 0, 0, 0, 0, 0, 0, 0, 0, 0, 0, 0, 0, 0, 0], 
[0, 0, 0, 0, 0, 0, 0, 0, 0, 0, 0, 0, 0, 0, 0, 0, 0, 0, 0, 0, 0, 0, 0, 0, 0, 0, 0, 0, 0, 0, 0, 0, 0, 0, 0, 0], 
[0, 0, 0, 0, 0, 0, 0, 0, 1662, 1681, 1682, 0, 0, 0, 1680, 1681, 1663, 0, 0, 0, 0, 0, 0, 0, 0, 0, 0, 0, 0, 0, 0, 0, 0, 0, 0, 0], 
[0, 0, 0, 0, 0, 0, 0, 0, 1665, 0, 0, 0, 0, 0, 0, 0, 1664, 0, 0, 0, 0, 0, 0, 0, 0, 0, 0, 0, 0, 0, 0, 0, 0, 0, 0, 0], 
[0, 0, 0, 0, 0, 0, 0, 0, 1000, 1001, 1001, 1002, 0, 1000, 1001, 1001, 1002, 0, 0, 0, 0, 0, 0, 0, 0, 0, 0, 0, 0, 0, 0, 0, 0, 0, 0, 0], 
[0, 0, 0, 0, 0, 0, 0, 0, 1008, 1009, 1009, 1010, 0, 1008, 1009, 1009, 1010, 0, 0, 0, 0, 0, 0, 0, 0, 0, 0, 0, 0, 0, 0, 0, 0, 0, 0, 0], 
[0, 0, 0, 0, 0, 0, 0, 0, 1000, 1001, 1001, 1002, 0, 1000, 1001, 1001, 1002, 0, 0, 0, 0, 0, 0, 0, 0, 0, 0, 0, 0, 0, 0, 0, 0, 0, 0, 0], 
[0, 0, 0, 0, 0, 0, 0, 0, 1008, 1009, 1009, 1010, 0, 1008, 1009, 1009, 1010, 0, 0, 0, 0, 0, 0, 0, 0, 0, 0, 0, 0, 0, 0, 0, 0, 0, 0, 0], 
[0, 0, 0, 0, 0, 0, 0, 0, 1678, 1681, 1681, 1681, 1681, 1681, 1681, 1681, 1676, 1663, 0, 0, 1662, 1681, 1681, 1681, 1681, 1681, 1681, 1682, 0, 0, 0, 0, 0, 0, 0, 0], 
[0, 0, 0, 0, 0, 0, 0, 0, 0, 0, 0, 0, 0, 0, 0, 0, 0, 1672, 0, 0, 1673, 0, 0, 0, 0, 0, 0, 0, 0, 0, 0, 0, 0, 0, 0, 0], 
[0, 0, 0, 0, 0, 0, 0, 0, 0, 0, 0, 0, 0, 0, 0, 0, 0, 0, 0, 0, 0, 0, 0, 0, 0, 0, 0, 0, 0, 0, 0, 0, 0, 0, 0, 0], 
[0, 0, 0, 0, 0, 0, 0, 0, 0, 0, 0, 0, 0, 0, 0, 0, 0, 0, 0, 0, 0, 0, 0, 0, 0, 0, 0, 0, 0, 0, 0, 0, 0, 0, 0, 0]], 

[[0, 0, 0, 0, 0, 0, 0, 0, 0, 0, 0, 0, 0, 0, 0, 0, 0, 0, 0, 0, 0, 0, 0, 0, 0, 0, 0, 0, 0, 0, 0, 0, 0, 0, 0, 0], 
[0, 0, 0, 0, 0, 0, 0, 0, 0, 0, 0, 0, 0, 0, 0, 0, 0, 0, 0, 0, 0, 0, 0, 0, 0, 0, 0, 0, 0, 0, 0, 0, 0, 0, 0, 0], 
[0, 0, 0, 0, 0, 0, 0, 0, 0, 0, 0, 0, 0, 0, 0, 0, 0, 0, 0, 0, 0, 0, 0, 0, 0, 0, 0, 0, 0, 0, 0, 0, 0, 0, 0, 0], 
[0, 0, 0, 0, 0, 0, 0, 0, 0, 0, 0, 0, 0, 0, 0, 0, 0, 0, 0, 0, 0, 0, 0, 0, 0, 0, 0, 0, 0, 0, 0, 0, 0, 0, 0, 0], 
[0, 0, 0, 0, 0, 0, 0, 0, 0, 0, 0, 0, 0, 0, 0, 0, 0, 0, 0, 0, 0, 0, 0, 0, 0, 0, 0, 0, 0, 0, 0, 0, 0, 0, 0, 0], 
[0, 0, 0, 0, 0, 0, 0, 0, 0, 0, 0, 0, 0, 0, 0, 0, 0, 0, 0, 0, 0, 0, 0, 0, 0, 0, 0, 0, 0, 0, 0, 0, 0, 0, 0, 0], 
[0, 0, 0, 0, 0, 0, 0, 0, 0, 0, 0, 0, 0, 0, 0, 0, 0, 0, 0, 0, 0, 0, 0, 0, 0, 0, 0, 0, 0, 0, 0, 0, 0, 0, 0, 0], 
[0, 0, 0, 0, 0, 0, 0, 0, 0, 0, 0, 0, 0, 0, 0, 0, 0, 0, 0, 0, 0, 0, 0, 0, 0, 0, 0, 0, 0, 0, 0, 0, 0, 0, 0, 0], 
[0, 0, 0, 0, 0, 0, 0, 0, 0, 0, 0, 0, 0, 0, 0, 0, 0, 0, 0, 0, 0, 0, 0, 0, 0, 0, 0, 0, 0, 0, 0, 0, 0, 0, 0, 0], 
[0, 0, 0, 0, 0, 0, 0, 0, 804, 805, 0, 0, 0, 0, 0, 0, 0, 0, 0, 804, 805, 804, 805, 0, 0, 0, 804, 805, 0, 0, 0, 0, 0, 0, 0, 0], 
[0, 0, 0, 0, 0, 0, 0, 0, 0, 0, 0, 0, 0, 0, 0, 0, 0, 0, 0, 0, 0, 0, 0, 0, 0, 0, 0, 0, 0, 0, 0, 0, 0, 0, 0, 0], 
[0, 0, 0, 0, 0, 0, 0, 0, 0, 0, 0, 0, 0, 0, 0, 0, 0, 0, 0, 0, 0, 0, 0, 0, 0, 0, 0, 0, 0, 0, 0, 0, 0, 0, 0, 0], 
[0, 0, 0, 0, 0, 0, 0, 0, 0, 0, 0, 0, 0, 0, 0, 0, 0, 0, 0, 0, 0, 0, 0, 0, 0, 0, 0, 0, 0, 0, 0, 0, 0, 0, 0, 0], 
[0, 0, 0, 0, 0, 0, 0, 0, 0, 0, 0, 0, 0, 0, 0, 0, 0, 0, 0, 0, 0, 0, 0, 0, 0, 0, 0, 0, 0, 0, 0, 0, 0, 0, 0, 0], 
[0, 0, 0, 0, 0, 0, 0, 0, 0, 0, 0, 0, 0, 0, 0, 0, 0, 0, 0, 0, 0, 0, 0, 0, 0, 0, 0, 0, 0, 0, 0, 0, 0, 0, 0, 0], 
[0, 0, 0, 0, 0, 0, 0, 0, 0, 0, 0, 0, 0, 0, 0, 0, 0, 0, 0, 0, 0, 0, 0, 0, 0, 0, 0, 0, 0, 0, 0, 0, 0, 0, 0, 0], 
[0, 0, 0, 0, 0, 0, 0, 0, 1665, 0, 0, 0, 0, 0, 0, 0, 1664, 0, 0, 0, 0, 0, 0, 0, 0, 0, 0, 0, 0, 0, 0, 0, 0, 0, 0, 0], 
[0, 0, 0, 0, 0, 0, 0, 0, 1665, 0, 0, 0, 0, 0, 0, 0, 1664, 0, 0, 0, 0, 0, 0, 0, 0, 0, 0, 0, 0, 0, 0, 0, 0, 0, 0, 0], 
[0, 0, 0, 0, 0, 0, 0, 0, 1665, 0, 0, 0, 0, 0, 0, 0, 1664, 0, 0, 0, 0, 0, 0, 0, 0, 0, 0, 0, 0, 0, 0, 0, 0, 0, 0, 0], 
[0, 0, 0, 0, 0, 0, 0, 0, 1665, 0, 0, 0, 0, 0, 0, 0, 1664, 0, 0, 0, 0, 0, 0, 0, 0, 0, 0, 0, 0, 0, 0, 0, 0, 0, 0, 0], 
[0, 0, 0, 0, 0, 0, 0, 0, 0, 0, 0, 0, 0, 0, 0, 0, 0, 0, 0, 0, 0, 0, 0, 0, 0, 0, 0, 0, 0, 0, 0, 0, 0, 0, 0, 0], 
[0, 0, 0, 0, 0, 0, 0, 0, 804, 805, 804, 805, 804, 805, 804, 805, 804, 805, 0, 0, 804, 805, 804, 805, 804, 805, 804, 805, 0, 0, 0, 0, 0, 0, 0, 0], 
[0, 0, 0, 0, 0, 0, 0, 0, 0, 0, 0, 0, 0, 0, 0, 0, 0, 0, 0, 0, 0, 0, 0, 0, 0, 0, 0, 0, 0, 0, 0, 0, 0, 0, 0, 0], 
[0, 0, 0, 0, 0, 0, 0, 0, 0, 0, 0, 0, 0, 0, 0, 0, 0, 0, 0, 0, 0, 0, 0, 0, 0, 0, 0, 0, 0, 0, 0, 0, 0, 0, 0, 0]]]
}
}
