{
	"Map": {
		"id": 27,
		"map_display_x": 0,
		"map_display_y": 0,
		"width": 20,
		"height": 15,
		"xsize": 20,
		"ysize": 15,
		"zsize": 3,
		"Name" : "Pokémon Day Care",
		"Parent" : "Lerucean Town",
		"Tileset" : "Interior general",
		"BattleBack" : "",
		"Autoplay_bgm" : true,
		"BGM" : "021-Field04",
		"Autoplay_bgs" : false,
		"BGS" : "",
		"Encounter_list" : [],
		"Encounter_step" : 30,
		"table": [[[432, 433, 433, 433, 433, 433, 433, 433, 433, 433, 433, 434, 542, 542, 542, 542, 542, 542, 542, 542], 
[440, 441, 441, 441, 441, 441, 441, 441, 441, 441, 441, 442, 542, 542, 542, 542, 542, 542, 542, 542], 
[1037, 1045, 1045, 1045, 1077, 1069, 1071, 1077, 1077, 1077, 1077, 1063, 542, 542, 542, 542, 542, 542, 542, 542], 
[1055, 1054, 1054, 1054, 1060, 1192, 1193, 1193, 1193, 1193, 1194, 1060, 542, 542, 542, 542, 542, 542, 542, 542], 
[1069, 1060, 1060, 1060, 1060, 1200, 1201, 1201, 1201, 1201, 1202, 1060, 542, 542, 542, 542, 542, 542, 542, 542], 
[1069, 1060, 1060, 1060, 1060, 1200, 1201, 1201, 1201, 1201, 1202, 1060, 542, 542, 542, 542, 542, 542, 542, 542], 
[1069, 1060, 1060, 1060, 1060, 1208, 1209, 1209, 1209, 1209, 1210, 1060, 542, 542, 542, 542, 542, 542, 542, 542], 
[1069, 1060, 1060, 1060, 1060, 1060, 1060, 1060, 1060, 1060, 1060, 1060, 542, 542, 542, 542, 542, 542, 542, 542], 
[542, 542, 542, 542, 542, 542, 542, 542, 542, 542, 542, 542, 542, 542, 542, 542, 542, 542, 542, 542], 
[542, 542, 542, 542, 542, 542, 542, 542, 542, 542, 542, 542, 542, 542, 542, 542, 542, 542, 542, 542], 
[542, 542, 542, 542, 542, 542, 542, 542, 542, 542, 542, 542, 542, 542, 542, 542, 542, 542, 542, 542], 
[542, 542, 542, 542, 542, 542, 542, 542, 542, 542, 542, 542, 542, 542, 542, 542, 542, 542, 542, 542], 
[542, 542, 542, 542, 542, 542, 542, 542, 542, 542, 542, 542, 542, 542, 542, 542, 542, 542, 542, 542], 
[542, 542, 542, 542, 542, 542, 542, 542, 542, 542, 542, 542, 542, 542, 542, 542, 542, 542, 542, 542], 
[542, 542, 542, 542, 542, 542, 542, 542, 542, 542, 542, 542, 542, 542, 542, 542, 542, 542, 542, 542]], 

[[0, 389, 390, 391, 0, 1693, 0, 0, 1493, 1493, 0, 0, 0, 0, 0, 0, 0, 0, 0, 0], 
[0, 397, 398, 399, 2162, 1701, 0, 0, 1501, 1501, 0, 0, 0, 0, 0, 0, 0, 0, 0, 0], 
[448, 0, 0, 0, 2170, 1709, 0, 0, 0, 0, 0, 450, 0, 0, 0, 0, 0, 0, 0, 0], 
[2177, 2177, 2177, 2177, 2178, 0, 0, 0, 0, 0, 0, 0, 0, 0, 0, 0, 0, 0, 0, 0], 
[1756, 0, 0, 0, 0, 0, 1671, 2131, 2133, 1671, 0, 0, 0, 0, 0, 0, 0, 0, 0, 0], 
[1764, 0, 0, 0, 0, 0, 1671, 2139, 2141, 1671, 0, 0, 0, 0, 0, 0, 0, 0, 0, 0], 
[1756, 0, 0, 0, 0, 0, 0, 0, 0, 0, 0, 1756, 0, 0, 0, 0, 0, 0, 0, 0], 
[1764, 0, 0, 1245, 1246, 1247, 0, 0, 0, 0, 0, 1764, 0, 0, 0, 0, 0, 0, 0, 0], 
[0, 0, 0, 1253, 1254, 1255, 0, 0, 0, 0, 0, 0, 0, 0, 0, 0, 0, 0, 0, 0], 
[0, 0, 0, 0, 0, 0, 0, 0, 0, 0, 0, 0, 0, 0, 0, 0, 0, 0, 0, 0], 
[0, 0, 0, 0, 0, 0, 0, 0, 0, 0, 0, 0, 0, 0, 0, 0, 0, 0, 0, 0], 
[0, 0, 0, 0, 0, 0, 0, 0, 0, 0, 0, 0, 0, 0, 0, 0, 0, 0, 0, 0], 
[0, 0, 0, 0, 0, 0, 0, 0, 0, 0, 0, 0, 0, 0, 0, 0, 0, 0, 0, 0], 
[0, 0, 0, 0, 0, 0, 0, 0, 0, 0, 0, 0, 0, 0, 0, 0, 0, 0, 0, 0], 
[0, 0, 0, 0, 0, 0, 0, 0, 0, 0, 0, 0, 0, 0, 0, 0, 0, 0, 0, 0]], 

[[0, 0, 0, 0, 0, 0, 0, 0, 0, 0, 0, 0, 0, 0, 0, 0, 0, 0, 0, 0], 
[0, 0, 0, 0, 0, 0, 0, 0, 0, 0, 0, 0, 0, 0, 0, 0, 0, 0, 0, 0], 
[0, 0, 0, 0, 0, 0, 0, 0, 0, 0, 0, 0, 0, 0, 0, 0, 0, 0, 0, 0], 
[0, 0, 0, 0, 0, 0, 0, 0, 0, 0, 0, 0, 0, 0, 0, 0, 0, 0, 0, 0], 
[0, 0, 0, 0, 0, 0, 0, 0, 0, 0, 0, 0, 0, 0, 0, 0, 0, 0, 0, 0], 
[0, 0, 0, 0, 0, 0, 0, 0, 0, 0, 0, 0, 0, 0, 0, 0, 0, 0, 0, 0], 
[0, 0, 0, 0, 0, 0, 0, 0, 0, 0, 0, 0, 0, 0, 0, 0, 0, 0, 0, 0], 
[0, 0, 0, 0, 0, 0, 0, 0, 0, 0, 0, 0, 0, 0, 0, 0, 0, 0, 0, 0], 
[0, 0, 0, 0, 0, 0, 0, 0, 0, 0, 0, 0, 0, 0, 0, 0, 0, 0, 0, 0], 
[0, 0, 0, 0, 0, 0, 0, 0, 0, 0, 0, 0, 0, 0, 0, 0, 0, 0, 0, 0], 
[0, 0, 0, 0, 0, 0, 0, 0, 0, 0, 0, 0, 0, 0, 0, 0, 0, 0, 0, 0], 
[0, 0, 0, 0, 0, 0, 0, 0, 0, 0, 0, 0, 0, 0, 0, 0, 0, 0, 0, 0], 
[0, 0, 0, 0, 0, 0, 0, 0, 0, 0, 0, 0, 0, 0, 0, 0, 0, 0, 0, 0], 
[0, 0, 0, 0, 0, 0, 0, 0, 0, 0, 0, 0, 0, 0, 0, 0, 0, 0, 0, 0], 
[0, 0, 0, 0, 0, 0, 0, 0, 0, 0, 0, 0, 0, 0, 0, 0, 0, 0, 0, 0]]]
}
}
