{
	"Map": {
		"id": 54,
		"map_display_x": 0,
		"map_display_y": 0,
		"width": 20,
		"height": 15,
		"xsize": 20,
		"ysize": 15,
		"zsize": 3,
		"Name" : "Battle Frontier Mart",
		"Parent" : "Battle Frontier",
		"Tileset" : "Mart interior",
		"BattleBack" : "",
		"Autoplay_bgm" : true,
		"BGM" : "Poke Mart",
		"Autoplay_bgs" : false,
		"BGS" : "",
		"Encounter_list" : [],
		"Encounter_step" : 30,
		"table": [[[409, 385, 385, 385, 385, 385, 385, 385, 385, 385, 409, 409, 409, 409, 409, 409, 409, 409, 409, 409], 
[409, 393, 393, 393, 393, 393, 393, 393, 393, 393, 409, 409, 409, 409, 409, 409, 409, 409, 409, 409], 
[425, 433, 433, 425, 443, 433, 433, 423, 425, 425, 425, 409, 409, 409, 409, 409, 409, 409, 409, 409], 
[407, 416, 416, 425, 426, 416, 416, 416, 416, 416, 440, 409, 409, 409, 409, 409, 409, 409, 409, 409], 
[425, 425, 425, 425, 426, 416, 416, 425, 425, 427, 425, 409, 409, 409, 409, 409, 409, 409, 409, 409], 
[425, 433, 433, 433, 434, 416, 416, 425, 425, 426, 425, 409, 409, 409, 409, 409, 409, 409, 409, 409], 
[425, 425, 425, 427, 416, 416, 416, 425, 425, 426, 425, 409, 409, 409, 409, 409, 409, 409, 409, 409], 
[425, 441, 433, 434, 416, 416, 416, 441, 433, 434, 424, 409, 409, 409, 409, 409, 409, 409, 409, 409], 
[409, 409, 409, 409, 409, 409, 409, 409, 409, 409, 409, 409, 409, 409, 409, 409, 409, 409, 409, 409], 
[409, 409, 409, 409, 409, 409, 409, 409, 409, 409, 409, 409, 409, 409, 409, 409, 409, 409, 409, 409], 
[409, 409, 409, 409, 409, 409, 409, 409, 409, 409, 409, 409, 409, 409, 409, 409, 409, 409, 409, 409], 
[409, 409, 409, 409, 409, 409, 409, 409, 409, 409, 409, 409, 409, 409, 409, 409, 409, 409, 409, 409], 
[409, 409, 409, 409, 409, 409, 409, 409, 409, 409, 409, 409, 409, 409, 409, 409, 409, 409, 409, 409], 
[409, 409, 409, 409, 409, 409, 409, 409, 409, 409, 409, 409, 409, 409, 409, 409, 409, 409, 409, 409], 
[409, 409, 409, 409, 409, 409, 409, 409, 409, 409, 409, 409, 409, 409, 409, 409, 409, 409, 409, 409]], 

[[384, 0, 388, 0, 387, 387, 387, 485, 486, 487, 386, 0, 0, 0, 0, 0, 0, 0, 0, 0], 
[392, 390, 396, 456, 395, 395, 395, 493, 494, 495, 394, 0, 0, 0, 0, 0, 0, 0, 0, 0], 
[400, 398, 0, 464, 0, 0, 0, 501, 502, 503, 402, 0, 0, 0, 0, 0, 0, 0, 0, 0], 
[488, 489, 491, 480, 0, 0, 0, 454, 455, 0, 454, 0, 0, 0, 0, 0, 0, 0, 0, 0], 
[496, 497, 499, 472, 0, 0, 0, 462, 463, 0, 462, 0, 0, 0, 0, 0, 0, 0, 0, 0], 
[0, 488, 491, 0, 0, 0, 0, 470, 471, 0, 470, 0, 0, 0, 0, 0, 0, 0, 0, 0], 
[0, 496, 499, 0, 0, 0, 0, 478, 479, 0, 478, 0, 0, 0, 0, 0, 0, 0, 0, 0], 
[408, 0, 0, 403, 404, 405, 0, 0, 0, 0, 410, 0, 0, 0, 0, 0, 0, 0, 0, 0], 
[0, 0, 0, 411, 412, 413, 0, 0, 0, 0, 0, 0, 0, 0, 0, 0, 0, 0, 0, 0], 
[0, 0, 0, 0, 0, 0, 0, 0, 0, 0, 0, 0, 0, 0, 0, 0, 0, 0, 0, 0], 
[0, 0, 0, 0, 0, 0, 0, 0, 0, 0, 0, 0, 0, 0, 0, 0, 0, 0, 0, 0], 
[0, 0, 0, 0, 0, 0, 0, 0, 0, 0, 0, 0, 0, 0, 0, 0, 0, 0, 0, 0], 
[0, 0, 0, 0, 0, 0, 0, 0, 0, 0, 0, 0, 0, 0, 0, 0, 0, 0, 0, 0], 
[0, 0, 0, 0, 0, 0, 0, 0, 0, 0, 0, 0, 0, 0, 0, 0, 0, 0, 0, 0], 
[0, 0, 0, 0, 0, 0, 0, 0, 0, 0, 0, 0, 0, 0, 0, 0, 0, 0, 0, 0]], 

[[0, 0, 0, 0, 0, 0, 0, 0, 0, 0, 0, 0, 0, 0, 0, 0, 0, 0, 0, 0], 
[0, 0, 0, 452, 0, 0, 0, 0, 0, 0, 0, 0, 0, 0, 0, 0, 0, 0, 0, 0], 
[0, 0, 0, 460, 0, 0, 0, 0, 0, 0, 0, 0, 0, 0, 0, 0, 0, 0, 0, 0], 
[0, 0, 0, 0, 0, 0, 0, 0, 0, 0, 0, 0, 0, 0, 0, 0, 0, 0, 0, 0], 
[0, 0, 0, 0, 0, 0, 0, 0, 0, 0, 0, 0, 0, 0, 0, 0, 0, 0, 0, 0], 
[0, 0, 0, 0, 0, 0, 0, 0, 0, 0, 0, 0, 0, 0, 0, 0, 0, 0, 0, 0], 
[0, 0, 0, 0, 0, 0, 0, 0, 0, 0, 0, 0, 0, 0, 0, 0, 0, 0, 0, 0], 
[0, 0, 0, 0, 0, 0, 0, 0, 0, 0, 0, 0, 0, 0, 0, 0, 0, 0, 0, 0], 
[0, 0, 0, 0, 0, 0, 0, 0, 0, 0, 0, 0, 0, 0, 0, 0, 0, 0, 0, 0], 
[0, 0, 0, 0, 0, 0, 0, 0, 0, 0, 0, 0, 0, 0, 0, 0, 0, 0, 0, 0], 
[0, 0, 0, 0, 0, 0, 0, 0, 0, 0, 0, 0, 0, 0, 0, 0, 0, 0, 0, 0], 
[0, 0, 0, 0, 0, 0, 0, 0, 0, 0, 0, 0, 0, 0, 0, 0, 0, 0, 0, 0], 
[0, 0, 0, 0, 0, 0, 0, 0, 0, 0, 0, 0, 0, 0, 0, 0, 0, 0, 0, 0], 
[0, 0, 0, 0, 0, 0, 0, 0, 0, 0, 0, 0, 0, 0, 0, 0, 0, 0, 0, 0], 
[0, 0, 0, 0, 0, 0, 0, 0, 0, 0, 0, 0, 0, 0, 0, 0, 0, 0, 0, 0]]]
}
}
