{
	"Map": {
		"id": 36,
		"map_display_x": 0,
		"map_display_y": 0,
		"width": 25,
		"height": 19,
		"xsize": 25,
		"ysize": 19,
		"zsize": 3,
		"Name" : "Pokémon League",
		"Parent" : "Ingido Plateau",
		"Tileset" : "Poke Centre interior",
		"BattleBack" : "",
		"Autoplay_bgm" : true,
		"BGM" : "PkmRS-BTower",
		"Autoplay_bgs" : false,
		"BGS" : "",
		"Encounter_list" : [],
		"Encounter_step" : 30,
		"table": [[[384, 385, 385, 416, 417, 418, 385, 385, 386, 387, 387, 387, 387, 387, 387, 387, 387, 387, 387, 387, 387, 387, 387, 387, 387], 
[392, 393, 393, 424, 425, 426, 393, 393, 394, 387, 387, 387, 387, 387, 387, 387, 387, 387, 387, 387, 387, 387, 387, 387, 387], 
[400, 480, 457, 475, 465, 465, 457, 475, 402, 387, 387, 387, 387, 387, 387, 387, 387, 387, 387, 387, 387, 387, 387, 387, 387], 
[457, 448, 448, 485, 486, 487, 448, 448, 472, 387, 387, 387, 387, 387, 387, 387, 387, 387, 387, 387, 387, 387, 387, 387, 387], 
[457, 448, 448, 493, 494, 495, 448, 448, 448, 387, 387, 387, 387, 387, 387, 387, 387, 387, 387, 387, 387, 387, 387, 387, 387], 
[457, 457, 459, 501, 502, 503, 448, 448, 448, 387, 387, 387, 387, 387, 387, 387, 387, 387, 387, 387, 387, 387, 387, 387, 387], 
[457, 457, 458, 448, 448, 448, 448, 448, 448, 388, 387, 387, 387, 387, 387, 387, 387, 387, 387, 387, 387, 387, 387, 387, 387], 
[457, 457, 458, 448, 448, 448, 448, 448, 448, 396, 397, 387, 387, 387, 387, 387, 387, 387, 387, 387, 387, 387, 387, 387, 387], 
[457, 457, 458, 448, 448, 448, 448, 448, 448, 404, 405, 385, 385, 385, 385, 385, 385, 385, 385, 385, 385, 385, 385, 385, 386], 
[457, 465, 466, 448, 448, 448, 448, 448, 448, 402, 413, 393, 393, 393, 393, 393, 393, 393, 393, 393, 393, 393, 393, 393, 394], 
[457, 448, 448, 451, 448, 448, 448, 448, 448, 472, 457, 457, 457, 475, 465, 457, 457, 457, 475, 465, 465, 465, 457, 457, 412], 
[457, 457, 457, 458, 448, 448, 448, 448, 448, 448, 457, 457, 457, 457, 457, 457, 457, 458, 448, 448, 448, 448, 448, 448, 472], 
[457, 473, 465, 466, 448, 448, 448, 448, 448, 448, 473, 465, 465, 465, 465, 465, 465, 466, 448, 448, 448, 448, 448, 448, 448], 
[457, 448, 448, 451, 448, 448, 448, 448, 448, 448, 485, 486, 487, 448, 448, 448, 448, 448, 448, 448, 451, 448, 448, 451, 448], 
[457, 457, 457, 458, 448, 448, 448, 448, 448, 448, 493, 494, 495, 448, 448, 448, 448, 448, 457, 457, 458, 457, 457, 458, 448], 
[457, 473, 465, 466, 448, 448, 448, 448, 448, 448, 501, 502, 503, 448, 448, 448, 448, 448, 473, 465, 466, 473, 465, 466, 448], 
[457, 448, 448, 448, 448, 448, 448, 448, 448, 448, 448, 448, 448, 448, 448, 448, 448, 448, 448, 448, 448, 448, 448, 448, 448], 
[387, 387, 387, 387, 387, 387, 387, 387, 387, 387, 387, 387, 387, 387, 387, 387, 387, 387, 387, 387, 387, 387, 387, 387, 387], 
[387, 387, 387, 387, 387, 387, 387, 387, 387, 387, 387, 387, 387, 387, 387, 387, 387, 387, 387, 387, 387, 387, 387, 387, 387]], 

[[0, 0, 0, 0, 0, 0, 0, 0, 0, 0, 0, 0, 0, 0, 0, 0, 0, 0, 0, 0, 0, 0, 0, 0, 0], 
[0, 0, 635, 0, 0, 0, 635, 0, 0, 0, 0, 0, 0, 0, 0, 0, 0, 0, 0, 0, 0, 0, 0, 0, 0], 
[0, 0, 643, 0, 0, 0, 643, 0, 0, 0, 0, 0, 0, 0, 0, 0, 0, 0, 0, 0, 0, 0, 0, 0, 0], 
[0, 0, 0, 0, 0, 0, 0, 0, 686, 0, 0, 0, 0, 0, 0, 0, 0, 0, 0, 0, 0, 0, 0, 0, 0], 
[570, 571, 0, 0, 0, 0, 0, 0, 694, 0, 0, 0, 0, 0, 0, 0, 0, 0, 0, 0, 0, 0, 0, 0, 0], 
[594, 579, 0, 0, 0, 0, 0, 0, 686, 0, 0, 0, 0, 0, 0, 0, 0, 0, 0, 0, 0, 0, 0, 0, 0], 
[0, 576, 0, 0, 0, 0, 0, 0, 694, 0, 0, 0, 0, 0, 0, 0, 0, 0, 0, 0, 0, 0, 0, 0, 0], 
[570, 587, 0, 0, 0, 0, 0, 0, 686, 0, 0, 0, 0, 0, 0, 0, 0, 0, 0, 0, 0, 0, 0, 0, 0], 
[594, 595, 0, 0, 0, 0, 0, 0, 694, 0, 0, 0, 0, 432, 433, 0, 0, 638, 0, 434, 435, 0, 636, 637, 0], 
[0, 0, 0, 0, 0, 0, 0, 0, 0, 0, 568, 581, 582, 440, 441, 583, 568, 646, 0, 442, 443, 0, 644, 645, 0], 
[623, 621, 622, 0, 0, 0, 0, 0, 0, 0, 585, 589, 590, 601, 570, 591, 587, 654, 0, 0, 0, 0, 652, 653, 0], 
[631, 629, 630, 0, 0, 0, 0, 0, 0, 0, 593, 594, 594, 609, 594, 594, 595, 0, 0, 0, 0, 0, 0, 0, 0], 
[0, 0, 0, 0, 0, 0, 0, 0, 0, 0, 0, 0, 0, 0, 0, 0, 0, 0, 0, 0, 0, 0, 0, 0, 0], 
[623, 621, 622, 0, 0, 0, 0, 0, 0, 0, 0, 0, 0, 0, 0, 0, 0, 0, 621, 622, 0, 621, 622, 631, 0], 
[631, 629, 630, 0, 0, 0, 0, 0, 0, 0, 0, 0, 0, 0, 0, 0, 0, 0, 629, 630, 0, 629, 630, 623, 0], 
[0, 623, 631, 0, 0, 0, 0, 0, 0, 0, 0, 0, 0, 0, 0, 0, 0, 0, 623, 631, 0, 623, 631, 0, 0], 
[481, 0, 0, 0, 0, 0, 0, 0, 0, 0, 552, 553, 554, 0, 0, 0, 0, 0, 0, 0, 0, 0, 0, 0, 482], 
[0, 0, 0, 0, 0, 0, 0, 0, 0, 0, 560, 561, 562, 0, 0, 0, 0, 0, 0, 0, 0, 0, 0, 0, 0], 
[0, 0, 0, 0, 0, 0, 0, 0, 0, 0, 0, 0, 0, 0, 0, 0, 0, 0, 0, 0, 0, 0, 0, 0, 0]], 

[[0, 0, 0, 0, 0, 0, 0, 0, 0, 0, 0, 0, 0, 0, 0, 0, 0, 0, 0, 0, 0, 0, 0, 0, 0], 
[0, 0, 0, 0, 0, 0, 0, 0, 0, 0, 0, 0, 0, 0, 0, 0, 0, 0, 0, 0, 0, 0, 0, 0, 0], 
[0, 0, 0, 0, 0, 0, 0, 0, 0, 0, 0, 0, 0, 0, 0, 0, 0, 0, 0, 0, 0, 0, 0, 0, 0], 
[0, 0, 0, 0, 0, 0, 0, 0, 0, 0, 0, 0, 0, 0, 0, 0, 0, 0, 0, 0, 0, 0, 0, 0, 0], 
[0, 0, 0, 0, 0, 0, 0, 0, 0, 0, 0, 0, 0, 0, 0, 0, 0, 0, 0, 0, 0, 0, 0, 0, 0], 
[0, 0, 0, 0, 0, 0, 0, 0, 0, 0, 0, 0, 0, 0, 0, 0, 0, 0, 0, 0, 0, 0, 0, 0, 0], 
[0, 0, 0, 0, 0, 0, 0, 0, 0, 0, 0, 0, 0, 0, 0, 0, 0, 0, 0, 0, 0, 0, 0, 0, 0], 
[0, 606, 0, 0, 0, 0, 0, 0, 0, 0, 0, 0, 0, 0, 0, 0, 0, 0, 0, 0, 0, 0, 0, 0, 0], 
[0, 614, 0, 0, 0, 0, 0, 0, 0, 0, 0, 0, 0, 0, 0, 0, 0, 0, 0, 0, 0, 0, 0, 0, 0], 
[0, 0, 0, 0, 0, 0, 0, 0, 0, 0, 0, 0, 0, 0, 0, 0, 0, 0, 0, 0, 0, 0, 0, 0, 0], 
[0, 0, 0, 0, 0, 0, 0, 0, 0, 0, 606, 0, 0, 0, 0, 0, 606, 0, 0, 0, 0, 0, 0, 0, 0], 
[0, 0, 0, 0, 0, 0, 0, 0, 0, 0, 614, 0, 0, 0, 0, 0, 614, 0, 0, 0, 0, 0, 0, 0, 0], 
[0, 0, 0, 0, 0, 0, 0, 0, 0, 0, 0, 0, 0, 0, 0, 0, 0, 0, 0, 0, 0, 0, 0, 0, 0], 
[0, 0, 0, 0, 0, 0, 0, 0, 0, 0, 0, 0, 0, 0, 0, 0, 0, 0, 0, 0, 0, 0, 0, 0, 0], 
[0, 0, 0, 0, 0, 0, 0, 0, 0, 0, 0, 0, 0, 0, 0, 0, 0, 0, 0, 0, 0, 0, 0, 0, 0], 
[0, 0, 0, 0, 0, 0, 0, 0, 0, 0, 0, 0, 0, 0, 0, 0, 0, 0, 0, 0, 0, 0, 0, 0, 0], 
[0, 0, 0, 0, 0, 0, 0, 0, 0, 0, 0, 0, 0, 0, 0, 0, 0, 0, 0, 0, 0, 0, 0, 0, 0], 
[0, 0, 0, 0, 0, 0, 0, 0, 0, 0, 0, 0, 0, 0, 0, 0, 0, 0, 0, 0, 0, 0, 0, 0, 0], 
[0, 0, 0, 0, 0, 0, 0, 0, 0, 0, 0, 0, 0, 0, 0, 0, 0, 0, 0, 0, 0, 0, 0, 0, 0]]]
}
}
