{
	"Map": {
		"id": 72,
		"map_display_x": 0,
		"map_display_y": 0,
		"width": 29,
		"height": 31,
		"xsize": 29,
		"ysize": 31,
		"zsize": 3,
		"Name" : "Berth Island",
		"Parent" : "",
		"Tileset" : "Outside",
		"BattleBack" : "",
		"Autoplay_bgm" : true,
		"BGM" : "022-Field05",
		"Autoplay_bgs" : false,
		"BGS" : "",
		"Encounter_list" : [],
		"Encounter_step" : 30,
		"table": [[[800, 801, 808, 809, 800, 801, 810, 811, 385, 385, 1193, 1187, 1188, 1193, 1177, 1192, 1188, 1189, 1192, 385, 385, 810, 811, 800, 801, 808, 809, 800, 801], 
[808, 809, 800, 801, 808, 809, 800, 801, 810, 811, 385, 385, 1193, 1179, 1177, 1181, 1192, 385, 385, 810, 811, 800, 801, 808, 809, 800, 801, 808, 809], 
[800, 801, 808, 809, 800, 801, 808, 809, 800, 801, 810, 811, 385, 1179, 1177, 1181, 385, 810, 811, 800, 801, 808, 809, 800, 801, 808, 809, 800, 801], 
[808, 809, 800, 801, 808, 809, 800, 801, 808, 809, 800, 803, 385, 1179, 1177, 1181, 385, 802, 801, 808, 809, 800, 801, 808, 809, 800, 801, 808, 809], 
[800, 801, 808, 809, 800, 801, 808, 809, 800, 801, 808, 811, 385, 1187, 1188, 1189, 385, 810, 809, 800, 801, 808, 809, 800, 801, 808, 809, 800, 801], 
[808, 809, 800, 801, 808, 809, 800, 801, 808, 809, 816, 819, 385, 385, 385, 385, 385, 818, 817, 808, 809, 800, 801, 808, 809, 800, 801, 808, 809], 
[800, 801, 808, 809, 800, 801, 808, 809, 816, 819, 385, 387, 388, 386, 389, 385, 389, 387, 385, 818, 817, 808, 809, 800, 801, 808, 809, 800, 801], 
[808, 809, 800, 801, 808, 809, 800, 803, 388, 389, 386, 389, 385, 387, 388, 386, 385, 388, 386, 387, 389, 802, 801, 808, 809, 800, 801, 808, 809], 
[800, 801, 808, 809, 800, 801, 808, 811, 385, 386, 387, 593, 627, 619, 387, 617, 628, 595, 386, 385, 386, 810, 809, 800, 801, 808, 809, 800, 801], 
[808, 809, 800, 801, 808, 809, 800, 803, 386, 388, 593, 599, 611, 386, 388, 387, 609, 607, 595, 387, 385, 802, 801, 808, 809, 800, 801, 808, 809], 
[800, 801, 808, 809, 800, 801, 808, 811, 387, 386, 637, 611, 387, 593, 594, 595, 385, 609, 638, 387, 388, 810, 809, 800, 801, 808, 809, 800, 801], 
[808, 809, 800, 801, 808, 809, 800, 803, 389, 385, 608, 389, 593, 614, 602, 612, 595, 385, 608, 386, 389, 802, 801, 808, 809, 800, 801, 808, 809], 
[800, 801, 808, 809, 800, 801, 808, 811, 386, 389, 385, 388, 601, 602, 602, 602, 603, 387, 386, 387, 385, 810, 809, 800, 801, 808, 809, 800, 801], 
[808, 809, 800, 801, 808, 809, 800, 803, 385, 386, 592, 387, 609, 598, 602, 596, 611, 388, 592, 385, 387, 802, 801, 808, 809, 800, 801, 808, 809], 
[800, 801, 808, 809, 800, 801, 808, 811, 388, 387, 645, 595, 386, 609, 610, 611, 387, 593, 646, 388, 386, 810, 809, 800, 801, 808, 809, 800, 801], 
[808, 809, 800, 801, 808, 809, 800, 803, 387, 385, 609, 607, 595, 388, 389, 386, 593, 599, 611, 386, 385, 802, 801, 808, 809, 800, 801, 808, 809], 
[818, 817, 808, 809, 800, 801, 808, 811, 389, 386, 385, 609, 635, 619, 385, 617, 636, 611, 389, 385, 387, 810, 809, 800, 801, 808, 809, 816, 819], 
[1188, 1193, 818, 817, 808, 809, 800, 803, 810, 811, 387, 386, 385, 386, 388, 387, 385, 388, 386, 810, 811, 802, 801, 808, 809, 816, 819, 1192, 1188], 
[1193, 1187, 1188, 1193, 818, 817, 808, 809, 800, 803, 389, 385, 387, 386, 385, 389, 386, 387, 385, 802, 801, 808, 809, 816, 819, 1192, 1188, 1189, 1192], 
[1187, 1188, 1193, 1187, 1188, 1193, 818, 817, 808, 811, 1192, 1188, 1188, 1188, 1161, 1188, 1188, 1188, 1193, 810, 809, 816, 819, 1192, 1188, 1189, 1192, 1188, 1189], 
[1177, 1193, 1187, 1188, 1193, 1187, 1188, 1193, 818, 819, 1181, 1192, 1188, 1188, 1161, 1188, 1188, 1193, 1179, 818, 819, 1192, 1188, 1189, 1192, 1188, 1189, 1192, 1177], 
[1177, 1177, 1177, 1193, 1187, 1188, 1193, 1187, 1188, 1188, 1189, 1181, 1192, 1177, 1161, 1177, 1193, 1179, 1187, 1188, 1188, 1189, 1192, 1188, 1189, 1192, 1177, 1177, 1177], 
[385, 385, 1177, 1177, 1177, 1193, 1187, 1188, 1188, 1188, 1188, 1189, 1177, 1177, 1177, 1177, 1177, 1187, 1188, 1188, 1188, 1188, 1189, 1192, 1177, 1177, 1177, 385, 385], 
[385, 385, 385, 385, 1177, 1177, 1177, 1177, 1177, 1177, 1177, 1177, 1177, 1177, 1177, 1177, 1177, 1177, 1177, 1177, 1177, 1177, 1177, 1177, 1177, 385, 385, 385, 385], 
[385, 385, 385, 385, 385, 385, 385, 385, 385, 385, 385, 385, 385, 385, 385, 385, 385, 385, 385, 385, 385, 385, 385, 385, 385, 385, 385, 385, 385], 
[385, 385, 385, 385, 385, 385, 385, 385, 385, 385, 385, 385, 385, 385, 385, 385, 385, 385, 385, 385, 385, 385, 385, 385, 385, 385, 385, 385, 385], 
[385, 385, 385, 385, 385, 385, 385, 385, 385, 385, 385, 385, 385, 385, 385, 385, 385, 385, 385, 385, 385, 385, 385, 385, 385, 385, 385, 385, 385], 
[385, 385, 385, 385, 385, 385, 385, 385, 385, 385, 385, 385, 385, 385, 385, 385, 385, 385, 385, 385, 385, 385, 385, 385, 385, 385, 385, 385, 385], 
[385, 385, 385, 385, 385, 385, 385, 385, 385, 385, 385, 385, 385, 385, 385, 385, 385, 385, 385, 385, 385, 385, 385, 385, 385, 385, 385, 385, 385], 
[385, 385, 385, 385, 385, 385, 385, 385, 385, 385, 385, 385, 385, 385, 385, 385, 385, 385, 385, 385, 385, 385, 385, 385, 385, 385, 385, 385, 385], 
[385, 385, 385, 385, 385, 385, 385, 385, 385, 385, 385, 385, 385, 385, 385, 385, 385, 385, 385, 385, 385, 385, 385, 385, 385, 385, 385, 385, 385]], 

[[0, 0, 0, 0, 0, 0, 0, 0, 1184, 1185, 0, 0, 0, 0, 0, 0, 0, 0, 0, 1185, 1186, 0, 0, 0, 0, 0, 0, 0, 0], 
[0, 0, 0, 0, 0, 0, 0, 0, 0, 0, 1184, 1185, 0, 0, 0, 0, 0, 1185, 1186, 0, 0, 0, 0, 0, 0, 0, 0, 0, 0], 
[0, 0, 0, 0, 0, 0, 0, 0, 0, 0, 0, 0, 1176, 0, 0, 0, 1178, 0, 0, 0, 0, 0, 0, 0, 0, 0, 0, 0, 0], 
[0, 0, 0, 0, 0, 0, 0, 0, 0, 0, 0, 0, 1176, 0, 0, 0, 1178, 0, 0, 0, 0, 0, 0, 0, 0, 0, 0, 0, 0], 
[0, 0, 0, 0, 0, 0, 0, 0, 0, 0, 0, 0, 1176, 0, 0, 0, 1178, 0, 0, 0, 0, 0, 0, 0, 0, 0, 0, 0, 0], 
[0, 0, 0, 0, 0, 0, 0, 0, 0, 0, 0, 0, 1184, 1185, 1185, 1185, 1186, 0, 0, 0, 0, 0, 0, 0, 0, 0, 0, 0, 0], 
[0, 0, 0, 0, 0, 0, 0, 0, 0, 0, 0, 0, 0, 0, 0, 0, 0, 0, 0, 0, 0, 0, 0, 0, 0, 0, 0, 0, 0], 
[0, 0, 0, 0, 0, 0, 0, 0, 0, 0, 0, 0, 0, 0, 0, 0, 0, 0, 0, 0, 0, 0, 0, 0, 0, 0, 0, 0, 0], 
[0, 0, 0, 0, 0, 0, 0, 0, 0, 0, 0, 0, 0, 0, 0, 0, 0, 0, 0, 0, 0, 0, 0, 0, 0, 0, 0, 0, 0], 
[0, 0, 0, 0, 0, 0, 0, 0, 0, 0, 0, 1327, 0, 0, 0, 0, 0, 1327, 0, 0, 0, 0, 0, 0, 0, 0, 0, 0, 0], 
[0, 0, 0, 0, 0, 0, 0, 0, 0, 0, 0, 0, 0, 0, 0, 0, 0, 0, 0, 0, 0, 0, 0, 0, 0, 0, 0, 0, 0], 
[0, 0, 0, 0, 0, 0, 0, 0, 0, 0, 0, 0, 0, 0, 0, 0, 0, 0, 0, 0, 0, 0, 0, 0, 0, 0, 0, 0, 0], 
[0, 0, 0, 0, 0, 0, 0, 0, 0, 0, 0, 0, 0, 0, 0, 0, 0, 0, 0, 0, 0, 0, 0, 0, 0, 0, 0, 0, 0], 
[0, 0, 0, 0, 0, 0, 0, 0, 0, 0, 0, 0, 0, 0, 0, 0, 0, 0, 0, 0, 0, 0, 0, 0, 0, 0, 0, 0, 0], 
[0, 0, 0, 0, 0, 0, 0, 0, 0, 0, 0, 0, 0, 0, 0, 0, 0, 0, 0, 0, 0, 0, 0, 0, 0, 0, 0, 0, 0], 
[0, 0, 0, 0, 0, 0, 0, 0, 0, 0, 0, 1327, 0, 0, 0, 0, 0, 1327, 0, 0, 0, 0, 0, 0, 0, 0, 0, 0, 0], 
[0, 0, 0, 0, 0, 0, 0, 0, 0, 0, 0, 0, 0, 0, 0, 0, 0, 0, 0, 0, 0, 0, 0, 0, 0, 0, 0, 0, 0], 
[0, 0, 0, 0, 0, 0, 0, 0, 0, 0, 0, 0, 0, 0, 0, 0, 0, 0, 0, 0, 0, 0, 0, 0, 0, 0, 0, 0, 0], 
[0, 0, 0, 0, 0, 0, 0, 0, 0, 0, 0, 0, 0, 0, 0, 0, 0, 0, 0, 0, 0, 0, 0, 0, 0, 0, 0, 0, 0], 
[0, 0, 0, 0, 0, 0, 0, 0, 0, 0, 0, 0, 0, 0, 0, 0, 0, 0, 0, 0, 0, 0, 0, 0, 0, 0, 0, 0, 0], 
[1185, 0, 0, 0, 0, 0, 0, 0, 0, 0, 0, 0, 0, 0, 0, 0, 0, 0, 0, 0, 0, 0, 0, 0, 0, 0, 0, 0, 1185], 
[84, 1184, 1185, 0, 0, 0, 0, 0, 0, 0, 0, 0, 0, 1185, 0, 1185, 0, 0, 0, 0, 0, 0, 0, 0, 0, 0, 1185, 1186, 82], 
[50, 68, 84, 1184, 1185, 0, 0, 0, 0, 0, 0, 0, 1178, 1589, 1590, 1591, 1176, 0, 0, 0, 0, 0, 0, 0, 1185, 1186, 82, 68, 49], 
[48, 48, 50, 68, 84, 1184, 1185, 1185, 1185, 1185, 1185, 1185, 1186, 1597, 1598, 1599, 1184, 1185, 1185, 1185, 1185, 1185, 1185, 1186, 82, 68, 49, 48, 48], 
[48, 48, 48, 48, 50, 68, 68, 68, 68, 68, 68, 68, 68, 1597, 1598, 1599, 68, 68, 68, 68, 68, 68, 68, 68, 49, 48, 48, 48, 48], 
[48, 48, 48, 48, 48, 48, 48, 48, 48, 48, 48, 48, 48, 48, 48, 48, 48, 48, 48, 48, 48, 48, 48, 48, 48, 48, 48, 48, 48], 
[48, 178, 180, 48, 48, 48, 48, 48, 48, 48, 48, 48, 48, 48, 48, 48, 48, 48, 48, 48, 48, 48, 48, 48, 48, 48, 178, 180, 48], 
[48, 184, 182, 48, 48, 48, 48, 48, 48, 48, 48, 48, 48, 48, 48, 48, 48, 48, 48, 48, 48, 48, 48, 48, 48, 48, 184, 182, 48], 
[48, 48, 48, 48, 48, 48, 178, 180, 48, 48, 48, 48, 48, 48, 48, 48, 48, 48, 48, 48, 48, 178, 180, 48, 48, 48, 48, 48, 48], 
[48, 48, 48, 48, 48, 48, 184, 182, 48, 48, 48, 48, 48, 48, 48, 48, 48, 48, 48, 48, 48, 184, 182, 48, 48, 48, 48, 48, 48], 
[76, 76, 76, 76, 76, 76, 76, 76, 76, 76, 76, 76, 76, 76, 76, 76, 76, 76, 76, 76, 76, 76, 76, 76, 76, 76, 76, 76, 56]], 

[[0, 0, 0, 0, 0, 0, 0, 0, 804, 805, 0, 0, 0, 0, 0, 0, 0, 0, 0, 804, 805, 0, 0, 0, 0, 0, 0, 0, 0], 
[0, 0, 0, 0, 0, 0, 0, 0, 0, 0, 804, 805, 0, 0, 0, 0, 0, 804, 805, 0, 0, 0, 0, 0, 0, 0, 0, 0, 0], 
[0, 0, 0, 0, 0, 0, 0, 0, 0, 0, 0, 0, 0, 0, 0, 0, 0, 0, 0, 0, 0, 0, 0, 0, 0, 0, 0, 0, 0], 
[0, 0, 0, 0, 0, 0, 0, 0, 0, 0, 0, 0, 0, 0, 0, 0, 0, 0, 0, 0, 0, 0, 0, 0, 0, 0, 0, 0, 0], 
[0, 0, 0, 0, 0, 0, 0, 0, 0, 0, 0, 0, 0, 0, 0, 0, 0, 0, 0, 0, 0, 0, 0, 0, 0, 0, 0, 0, 0], 
[0, 0, 0, 0, 0, 0, 0, 0, 0, 0, 0, 0, 0, 0, 0, 0, 0, 0, 0, 0, 0, 0, 0, 0, 0, 0, 0, 0, 0], 
[0, 0, 0, 0, 0, 0, 0, 0, 0, 0, 0, 0, 0, 0, 0, 0, 0, 0, 0, 0, 0, 0, 0, 0, 0, 0, 0, 0, 0], 
[0, 0, 0, 0, 0, 0, 0, 0, 0, 0, 0, 0, 0, 0, 0, 0, 0, 0, 0, 0, 0, 0, 0, 0, 0, 0, 0, 0, 0], 
[0, 0, 0, 0, 0, 0, 0, 0, 0, 0, 0, 0, 0, 0, 0, 0, 0, 0, 0, 0, 0, 0, 0, 0, 0, 0, 0, 0, 0], 
[0, 0, 0, 0, 0, 0, 0, 0, 0, 0, 0, 0, 0, 0, 0, 0, 0, 0, 0, 0, 0, 0, 0, 0, 0, 0, 0, 0, 0], 
[0, 0, 0, 0, 0, 0, 0, 0, 0, 0, 0, 0, 0, 0, 0, 0, 0, 0, 0, 0, 0, 0, 0, 0, 0, 0, 0, 0, 0], 
[0, 0, 0, 0, 0, 0, 0, 0, 0, 0, 0, 0, 0, 0, 0, 0, 0, 0, 0, 0, 0, 0, 0, 0, 0, 0, 0, 0, 0], 
[0, 0, 0, 0, 0, 0, 0, 0, 0, 0, 0, 0, 0, 0, 0, 0, 0, 0, 0, 0, 0, 0, 0, 0, 0, 0, 0, 0, 0], 
[0, 0, 0, 0, 0, 0, 0, 0, 0, 0, 0, 0, 0, 0, 0, 0, 0, 0, 0, 0, 0, 0, 0, 0, 0, 0, 0, 0, 0], 
[0, 0, 0, 0, 0, 0, 0, 0, 0, 0, 0, 0, 0, 0, 0, 0, 0, 0, 0, 0, 0, 0, 0, 0, 0, 0, 0, 0, 0], 
[0, 0, 0, 0, 0, 0, 0, 0, 0, 0, 0, 0, 0, 0, 0, 0, 0, 0, 0, 0, 0, 0, 0, 0, 0, 0, 0, 0, 0], 
[0, 0, 0, 0, 0, 0, 0, 0, 804, 805, 0, 0, 0, 0, 0, 0, 0, 0, 0, 804, 805, 0, 0, 0, 0, 0, 0, 0, 0], 
[0, 0, 0, 0, 0, 0, 0, 0, 0, 0, 0, 0, 0, 0, 0, 0, 0, 0, 0, 0, 0, 0, 0, 0, 0, 0, 0, 0, 0], 
[0, 0, 0, 0, 0, 0, 0, 0, 0, 0, 0, 0, 0, 0, 0, 0, 0, 0, 0, 0, 0, 0, 0, 0, 0, 0, 0, 0, 0], 
[0, 0, 0, 0, 0, 0, 0, 0, 0, 0, 0, 0, 0, 0, 0, 0, 0, 0, 0, 0, 0, 0, 0, 0, 0, 0, 0, 0, 0], 
[0, 0, 0, 0, 0, 0, 0, 0, 0, 0, 0, 0, 0, 0, 0, 0, 0, 0, 0, 0, 0, 0, 0, 0, 0, 0, 0, 0, 0], 
[0, 0, 0, 0, 0, 0, 0, 0, 0, 0, 0, 0, 0, 0, 0, 0, 0, 0, 0, 0, 0, 0, 0, 0, 0, 0, 0, 0, 0], 
[0, 0, 0, 0, 0, 0, 0, 0, 0, 0, 0, 0, 0, 0, 0, 0, 0, 0, 0, 0, 0, 0, 0, 0, 0, 0, 0, 0, 0], 
[0, 0, 0, 0, 0, 0, 0, 0, 0, 0, 0, 0, 0, 3355, 3356, 3357, 0, 0, 0, 0, 0, 0, 0, 0, 0, 0, 0, 0, 0], 
[0, 0, 0, 0, 0, 0, 0, 0, 0, 0, 0, 4216, 3688, 3689, 3690, 3691, 3692, 4217, 0, 0, 0, 0, 0, 0, 0, 0, 0, 0, 0], 
[0, 0, 0, 0, 0, 0, 0, 0, 0, 0, 0, 4232, 3696, 3697, 3698, 3699, 3700, 4233, 0, 0, 0, 0, 0, 0, 0, 0, 0, 0, 0], 
[0, 1506, 1507, 0, 0, 0, 0, 0, 0, 0, 0, 4224, 3704, 3705, 3706, 3707, 3708, 4225, 0, 0, 0, 0, 0, 0, 0, 0, 1506, 1507, 0], 
[0, 1514, 1515, 0, 0, 0, 0, 0, 0, 0, 0, 4232, 3712, 3713, 3714, 3715, 3716, 4233, 0, 0, 0, 0, 0, 0, 0, 0, 1514, 1515, 0], 
[0, 0, 0, 0, 0, 0, 1506, 1507, 0, 0, 0, 4240, 3720, 3721, 3722, 3723, 3724, 4241, 0, 0, 0, 1506, 1507, 0, 0, 0, 0, 0, 0], 
[0, 0, 0, 0, 0, 0, 1514, 1515, 0, 0, 0, 0, 0, 0, 0, 0, 0, 0, 0, 0, 0, 1514, 1515, 0, 0, 0, 0, 0, 0], 
[0, 0, 0, 0, 0, 0, 0, 0, 0, 0, 0, 0, 0, 0, 0, 0, 0, 0, 0, 0, 0, 0, 0, 0, 0, 0, 0, 0, 0]]]
}
}
