{
	"Map": {
		"id": 34,
		"map_display_x": 0,
		"map_display_y": 0,
		"width": 42,
		"height": 41,
		"xsize": 42,
		"ysize": 41,
		"zsize": 3,
		"Name" : "Ice Cave",
		"Parent" : "Route 3",
		"Tileset" : "Caves",
		"BattleBack" : "",
		"Autoplay_bgm" : true,
		"BGM" : "Dkc2cave",
		"Autoplay_bgs" : false,
		"BGS" : "",
		"Encounter_list" : [],
		"Encounter_step" : 30,
		"table": [[[0, 92, 140, 188, 236, 284, 332, 380, 1305, 1305, 1305, 1305, 1305, 1305, 1305, 1305, 1305, 1305, 1305, 1305, 1305, 1305, 1305, 1305, 1305, 1305, 1305, 1305, 1305, 1305, 1305, 1305, 1305, 1305, 1305, 1305, 1305, 1305, 1305, 1305, 1305, 1305], 
[384, 385, 386, 387, 388, 389, 390, 391, 1305, 1305, 1305, 1305, 1305, 1305, 1305, 1305, 1305, 1305, 1305, 1305, 1305, 1305, 1305, 1305, 1305, 1305, 1305, 1305, 1305, 1305, 1305, 1305, 1305, 1305, 1305, 1305, 1305, 1305, 1305, 1305, 1305, 1305], 
[1305, 1305, 1305, 1305, 1305, 1305, 1305, 1305, 1305, 1305, 1305, 1305, 1305, 1305, 1305, 1305, 1305, 1305, 1305, 1305, 1305, 1305, 1305, 1305, 1305, 1305, 1305, 1305, 1305, 1305, 1305, 1305, 1305, 1305, 1305, 1305, 1305, 1305, 1305, 1305, 1305, 1305], 
[1305, 1305, 1305, 1305, 1305, 1305, 1305, 1305, 1305, 1305, 1305, 1305, 1305, 1305, 1305, 1305, 1305, 1305, 1305, 1305, 1305, 1305, 1305, 1305, 1305, 1305, 1305, 1305, 1305, 1305, 1305, 1305, 1305, 1305, 1305, 1305, 1305, 1305, 1305, 1305, 1305, 1305], 
[1305, 1305, 1305, 1305, 1305, 1305, 1305, 1305, 1305, 1305, 1305, 1305, 1305, 1305, 1305, 1305, 1305, 1305, 1305, 1386, 1386, 1386, 1386, 1386, 1386, 1386, 1386, 1386, 1386, 1386, 1386, 1386, 1386, 1386, 1386, 1305, 1305, 1305, 1305, 1305, 1305, 1305], 
[1305, 1305, 1305, 1305, 1305, 1305, 1305, 1492, 1506, 1506, 1506, 1506, 1506, 1506, 1506, 1506, 1506, 1506, 1506, 1494, 1386, 1386, 1386, 1386, 1386, 1386, 1386, 1386, 1386, 1386, 1386, 1386, 1386, 1386, 1386, 1305, 1305, 1305, 1305, 1305, 1305, 1305], 
[1305, 1305, 1305, 1305, 1305, 1305, 1305, 1499, 1328, 1328, 1328, 1328, 1328, 1328, 1328, 1328, 1328, 1328, 1328, 1497, 1386, 1386, 1386, 1386, 1386, 1386, 1386, 1386, 1386, 1386, 1386, 1386, 1386, 1386, 1386, 1305, 1305, 1305, 1305, 1305, 1305, 1305], 
[1305, 1305, 1305, 1305, 1305, 1305, 1305, 1499, 1328, 1328, 1328, 1328, 1328, 1328, 1328, 1328, 1328, 1328, 1328, 1497, 1386, 1386, 1386, 1492, 1506, 1506, 1506, 1506, 1506, 1506, 1506, 1506, 1494, 1386, 1386, 1305, 1305, 1305, 1305, 1305, 1305, 1305], 
[1305, 1305, 1305, 1305, 1305, 1305, 1305, 1499, 1328, 1328, 1328, 1328, 1328, 1328, 1328, 1328, 1328, 1328, 1328, 1497, 1386, 1386, 1386, 1499, 1328, 1328, 1328, 1328, 1328, 1328, 1328, 1328, 1497, 1386, 1386, 1305, 1305, 1305, 1305, 1305, 1305, 1305], 
[1305, 1305, 1305, 1305, 1305, 1305, 1305, 1499, 1328, 1328, 1328, 1328, 1328, 1328, 1328, 1328, 1328, 1328, 1328, 1497, 1386, 1386, 1386, 1499, 1328, 1328, 1328, 1328, 1328, 1328, 1328, 1328, 1497, 1386, 1386, 1305, 1305, 1305, 1305, 1305, 1305, 1305], 
[1305, 1305, 1305, 1305, 1305, 1305, 1305, 1499, 1328, 1328, 1328, 1328, 1328, 1328, 1328, 1328, 1328, 1328, 1328, 1497, 1386, 1386, 1386, 1499, 1328, 1328, 1328, 1328, 1328, 1328, 1328, 1328, 1497, 1386, 1386, 1305, 1305, 1305, 1305, 1305, 1305, 1305], 
[1305, 1305, 1305, 1305, 1305, 1305, 1305, 1499, 1328, 1328, 1328, 1328, 1328, 1328, 1328, 1328, 1328, 1328, 1328, 1497, 1386, 1386, 1386, 1499, 1328, 1328, 1328, 1328, 1328, 1328, 1328, 1328, 1497, 1386, 1386, 1305, 1305, 1305, 1305, 1305, 1305, 1305], 
[1305, 1305, 1305, 1305, 1305, 1305, 1305, 1499, 1328, 1328, 1328, 1328, 1328, 1328, 1328, 1328, 1328, 1328, 1328, 1497, 1386, 1386, 1386, 1508, 1490, 1490, 1490, 1490, 1490, 1490, 1490, 1490, 1510, 1386, 1386, 1305, 1305, 1305, 1305, 1305, 1305, 1305], 
[1305, 1305, 1305, 1305, 1305, 1305, 1305, 1499, 1328, 1328, 1328, 1328, 1328, 1328, 1328, 1328, 1328, 1328, 1328, 1497, 1386, 1386, 1386, 1386, 1386, 1386, 1386, 1386, 1386, 1386, 1386, 1386, 1386, 1305, 1305, 1305, 1305, 1305, 1305, 1305, 1305, 1305], 
[1305, 1305, 1305, 1305, 1305, 1305, 1305, 1499, 1328, 1328, 1328, 1328, 1328, 1328, 1328, 1328, 1328, 1328, 1328, 1497, 1386, 1386, 1341, 1386, 1386, 1386, 1386, 1386, 1386, 1386, 1386, 1386, 1386, 1305, 1305, 1305, 1305, 1305, 1305, 1305, 1305, 1305], 
[1305, 1305, 1305, 1305, 1305, 1305, 1305, 1508, 1490, 1490, 1490, 1490, 1490, 1490, 1490, 1490, 1490, 1490, 1490, 1510, 1433, 1434, 1435, 1386, 1386, 1492, 1506, 1494, 1386, 1386, 1386, 1386, 1386, 1305, 1305, 1305, 1305, 1305, 1305, 1305, 1305, 1305], 
[1305, 1305, 1305, 1305, 1305, 1305, 1305, 1305, 1305, 1305, 1386, 1386, 1386, 1386, 1386, 1386, 1333, 1386, 1386, 1433, 1454, 1436, 1451, 1386, 1386, 1499, 1322, 1497, 1386, 1305, 1305, 1305, 1305, 1305, 1305, 1305, 1305, 1305, 1305, 1305, 1305, 1305], 
[1305, 1305, 1305, 1305, 1305, 1305, 1305, 1305, 1305, 1305, 1305, 1305, 1305, 1386, 1386, 1386, 1386, 1386, 1386, 1449, 1438, 1443, 1386, 1386, 1386, 1508, 1490, 1510, 1386, 1305, 1305, 1305, 1305, 1305, 1305, 1305, 1305, 1305, 1305, 1305, 1305, 1305], 
[1305, 1305, 1305, 1305, 1305, 1305, 1305, 1305, 1305, 1305, 1305, 1305, 1305, 1305, 1305, 1386, 1386, 1386, 1386, 1386, 1441, 1443, 1386, 1386, 1386, 1386, 1386, 1386, 1386, 1305, 1305, 1305, 1305, 1305, 1305, 1305, 1305, 1305, 1305, 1305, 1305, 1305], 
[1305, 1305, 1305, 1305, 1305, 1305, 1305, 1305, 1305, 1305, 1305, 1305, 1305, 1305, 1305, 1305, 1305, 1305, 1305, 1305, 1305, 1305, 1305, 1305, 1305, 1305, 1305, 1305, 1305, 1305, 1305, 1305, 1305, 1305, 1305, 1305, 1305, 1305, 1305, 1305, 1305, 1305], 
[1305, 1305, 1305, 1305, 1305, 1305, 1305, 1305, 1305, 1305, 1305, 1305, 1305, 1305, 1305, 1305, 1305, 1305, 1305, 1305, 1305, 1305, 1305, 1305, 1305, 1305, 1305, 1305, 1305, 1305, 1305, 1305, 1305, 1305, 1305, 1305, 1305, 1305, 1305, 1305, 1305, 1305], 
[1305, 1305, 1305, 1305, 1305, 1305, 1305, 1305, 1305, 1305, 1305, 1305, 1305, 1305, 1305, 1305, 1305, 1305, 1305, 1305, 1305, 1305, 1305, 1305, 1305, 1305, 1305, 1305, 1305, 1305, 1305, 1305, 1305, 1305, 1305, 1305, 1305, 1305, 1305, 1305, 1305, 1305], 
[1305, 1305, 1305, 1305, 1305, 1305, 1305, 1305, 1305, 1305, 1305, 1305, 1305, 1305, 1305, 1305, 1305, 1305, 1305, 1305, 1305, 1305, 1305, 1305, 1305, 1305, 1305, 1305, 1305, 1305, 1305, 1305, 1305, 1305, 1305, 1305, 1305, 1305, 1305, 1305, 1305, 1305], 
[1305, 1305, 1305, 1305, 1305, 1305, 1305, 1305, 1305, 1305, 1305, 1305, 1305, 1305, 1305, 1305, 1305, 1305, 1305, 1305, 1305, 1305, 1305, 1305, 1305, 1305, 1305, 1305, 1305, 1305, 1305, 1305, 1305, 1305, 1305, 1305, 1305, 1305, 1305, 1305, 1305, 1305], 
[1305, 1305, 1305, 1305, 1305, 1305, 1305, 1305, 1305, 1305, 1305, 1305, 1305, 1305, 1305, 1305, 1305, 1305, 1305, 1305, 1305, 1305, 1305, 1305, 1305, 1305, 1305, 1305, 1305, 1305, 1305, 1305, 1305, 1305, 1305, 1305, 1305, 1305, 1305, 1305, 1305, 1305], 
[1305, 1305, 1305, 1305, 1305, 1305, 1305, 1305, 1305, 1305, 1305, 1305, 1305, 1305, 1305, 1305, 1305, 1305, 1305, 1305, 1305, 1305, 1305, 1305, 1305, 1305, 1305, 1305, 1305, 1305, 1305, 1305, 1305, 1305, 1305, 1305, 1305, 1305, 1305, 1305, 1305, 1305], 
[1305, 1305, 1305, 1305, 1305, 1305, 1305, 1305, 1305, 1305, 1305, 1305, 1305, 1305, 1305, 1305, 1305, 1305, 1305, 1305, 1305, 1305, 1305, 1305, 1305, 1305, 1305, 1305, 1305, 1305, 1305, 1305, 1305, 1305, 1305, 1305, 1305, 1305, 1305, 1305, 1305, 1305], 
[1305, 1305, 1305, 1305, 1305, 1305, 1305, 1305, 1305, 1305, 1305, 1305, 1305, 1492, 1506, 1506, 1506, 1506, 1506, 1506, 1494, 1305, 1305, 1305, 1305, 1305, 1305, 1305, 1305, 1305, 1305, 1305, 1305, 1305, 1305, 1305, 1305, 1305, 1305, 1305, 1305, 1305], 
[1305, 1305, 1305, 1305, 1305, 1305, 1305, 1305, 1305, 1305, 1305, 1305, 1305, 1499, 1328, 1328, 1328, 1328, 1328, 1328, 1497, 1386, 1386, 1386, 1305, 1305, 1305, 1305, 1305, 1305, 1305, 1305, 1305, 1305, 1305, 1305, 1305, 1305, 1305, 1305, 1305, 1305], 
[1305, 1305, 1305, 1305, 1305, 1305, 1305, 1305, 1305, 1305, 1386, 1386, 1386, 1499, 1328, 1328, 1328, 1328, 1328, 1328, 1497, 1386, 1386, 1386, 1305, 1305, 1305, 1305, 1305, 1305, 1305, 1305, 1305, 1305, 1305, 1305, 1305, 1305, 1305, 1305, 1305, 1305], 
[1305, 1305, 1305, 1305, 1305, 1305, 1305, 1305, 1305, 1386, 1386, 1386, 1386, 1499, 1328, 1328, 1328, 1328, 1328, 1328, 1497, 1386, 1386, 1386, 1305, 1305, 1305, 1305, 1305, 1305, 1305, 1305, 1305, 1305, 1305, 1305, 1305, 1305, 1305, 1305, 1305, 1305], 
[1305, 1305, 1305, 1305, 1305, 1305, 1305, 1305, 1305, 1386, 1386, 1386, 1386, 1499, 1328, 1328, 1328, 1328, 1328, 1328, 1497, 1386, 1386, 1386, 1305, 1305, 1305, 1305, 1305, 1305, 1305, 1305, 1305, 1305, 1305, 1305, 1305, 1305, 1305, 1305, 1305, 1305], 
[1305, 1305, 1305, 1305, 1305, 1305, 1305, 1305, 1305, 1386, 1386, 1334, 1335, 1508, 1490, 1490, 1490, 1490, 1490, 1490, 1510, 1386, 1386, 1386, 1305, 1305, 1305, 1305, 1305, 1305, 1305, 1305, 1305, 1305, 1305, 1305, 1305, 1305, 1305, 1305, 1305, 1305], 
[1305, 1305, 1305, 1305, 1305, 1305, 1305, 1305, 1305, 1386, 1386, 1342, 1343, 1386, 1386, 1386, 1386, 1386, 1386, 1386, 1386, 1433, 1434, 1434, 1305, 1305, 1305, 1305, 1305, 1305, 1305, 1305, 1305, 1305, 1305, 1305, 1305, 1305, 1305, 1305, 1305, 1305], 
[1305, 1305, 1305, 1305, 1305, 1305, 1305, 1305, 1305, 1386, 1386, 1386, 1386, 1386, 1386, 1386, 1386, 1386, 1433, 1434, 1434, 1454, 1442, 1442, 1305, 1305, 1305, 1305, 1305, 1305, 1305, 1305, 1305, 1305, 1305, 1305, 1305, 1305, 1305, 1305, 1305, 1305], 
[1305, 1305, 1305, 1305, 1305, 1305, 1305, 1305, 1305, 1305, 1305, 1305, 1386, 1386, 1386, 1386, 1386, 1386, 1441, 1442, 1442, 1442, 1442, 1305, 1305, 1305, 1305, 1305, 1305, 1305, 1305, 1305, 1305, 1305, 1305, 1305, 1305, 1305, 1305, 1305, 1305, 1305], 
[1305, 1305, 1305, 1305, 1305, 1305, 1305, 1305, 1305, 1305, 1305, 1305, 1305, 1305, 1305, 1305, 1305, 1305, 1305, 1305, 1305, 1305, 1305, 1305, 1305, 1305, 1305, 1305, 1305, 1305, 1305, 1305, 1305, 1305, 1305, 1305, 1305, 1305, 1305, 1305, 1305, 1305], 
[1305, 1305, 1305, 1305, 1305, 1305, 1305, 1305, 1305, 1305, 1305, 1305, 1305, 1305, 1305, 1305, 1305, 1305, 1305, 1305, 1305, 1305, 1305, 1305, 1305, 1305, 1305, 1305, 1305, 1305, 1305, 1305, 1305, 1305, 1305, 1305, 1305, 1305, 1305, 1305, 1305, 1305], 
[1305, 1305, 1305, 1305, 1305, 1305, 1305, 1305, 1305, 1305, 1305, 1305, 1305, 1305, 1305, 1305, 1305, 1305, 1305, 1305, 1305, 1305, 1305, 1305, 1305, 1305, 1305, 1305, 1305, 1305, 1305, 1305, 1305, 1305, 1305, 1305, 1305, 1305, 1305, 1305, 1305, 1305], 
[1305, 1305, 1305, 1305, 1305, 1305, 1305, 1305, 1305, 1305, 1305, 1305, 1305, 1305, 1305, 1305, 1305, 1305, 1305, 1305, 1305, 1305, 1305, 1305, 1305, 1305, 1305, 1305, 1305, 1305, 1305, 1305, 1305, 1305, 1305, 1305, 1305, 1305, 1305, 1305, 1305, 1305], 
[1305, 1305, 1305, 1305, 1305, 1305, 1305, 1305, 1305, 1305, 1305, 1305, 1305, 1305, 1305, 1305, 1305, 1305, 1305, 1305, 1305, 1305, 1305, 1305, 1305, 1305, 1305, 1305, 1305, 1305, 1305, 1305, 1305, 1305, 1305, 1305, 1305, 1305, 1305, 1305, 1305, 1305]], 

[[0, 0, 1357, 0, 0, 0, 0, 1357, 0, 0, 0, 0, 0, 0, 0, 0, 1357, 0, 0, 0, 0, 0, 0, 0, 1357, 0, 0, 0, 0, 0, 0, 0, 0, 0, 0, 1357, 0, 0, 0, 0, 0, 0], 
[0, 0, 0, 0, 0, 0, 0, 0, 0, 0, 0, 0, 0, 0, 0, 0, 1357, 0, 0, 0, 0, 0, 0, 0, 0, 0, 0, 0, 0, 0, 0, 0, 1357, 0, 0, 0, 0, 0, 0, 0, 0, 0], 
[0, 0, 0, 0, 0, 0, 0, 0, 0, 1357, 0, 0, 1357, 0, 0, 0, 0, 0, 0, 0, 0, 1357, 0, 0, 0, 0, 1357, 1357, 0, 0, 0, 0, 0, 1357, 0, 0, 0, 0, 0, 1357, 1357, 0], 
[0, 0, 0, 1357, 0, 0, 0, 1357, 0, 0, 0, 0, 0, 0, 0, 1357, 1302, 1313, 1313, 1313, 1313, 1313, 1313, 1313, 1313, 1313, 1313, 1313, 1313, 1313, 1313, 1313, 1313, 1313, 1313, 1303, 0, 0, 0, 0, 1357, 0], 
[0, 0, 0, 0, 0, 0, 1302, 1313, 1313, 1313, 1313, 1313, 1313, 1313, 1313, 1313, 1314, 0, 1357, 1302, 1313, 1313, 1313, 1313, 1313, 1313, 1313, 1313, 1313, 1313, 1313, 1313, 1313, 1313, 1303, 1304, 0, 0, 0, 0, 0, 0], 
[0, 0, 0, 0, 0, 0, 1306, 1302, 1313, 1313, 1313, 1313, 1313, 1313, 1313, 1313, 1313, 1313, 1313, 1314, 1358, 1296, 1297, 1297, 1297, 1297, 1297, 1297, 1297, 1297, 1297, 1297, 1297, 1298, 1304, 1304, 0, 1357, 0, 0, 0, 0], 
[0, 1357, 0, 0, 0, 0, 1306, 1306, 0, 0, 0, 0, 0, 1367, 0, 0, 0, 0, 0, 1296, 1297, 1311, 1305, 1305, 1305, 1305, 1305, 1305, 1305, 1305, 1305, 1305, 1305, 1306, 1304, 1304, 0, 0, 0, 0, 0, 0], 
[0, 0, 0, 0, 0, 1357, 1306, 1306, 0, 0, 0, 0, 0, 0, 0, 0, 1367, 0, 0, 1304, 1305, 1305, 1305, 1302, 1313, 1313, 1313, 1313, 1313, 1313, 1313, 1313, 1313, 1314, 1304, 1304, 1357, 0, 0, 0, 0, 0], 
[0, 0, 0, 0, 0, 1357, 1306, 1306, 1367, 0, 0, 0, 0, 0, 0, 0, 0, 1367, 0, 1304, 1305, 1305, 1305, 1306, 0, 0, 0, 0, 0, 1367, 0, 0, 1349, 1358, 1304, 1304, 0, 0, 0, 0, 1357, 0], 
[0, 0, 1357, 0, 0, 0, 1306, 1306, 0, 0, 0, 0, 0, 0, 0, 0, 0, 0, 0, 1312, 1318, 1319, 1313, 1314, 0, 0, 0, 0, 0, 0, 0, 0, 0, 447, 1304, 1304, 1357, 0, 0, 0, 0, 0], 
[0, 0, 0, 0, 0, 0, 1306, 1306, 0, 0, 1367, 0, 0, 0, 0, 0, 0, 0, 0, 0, 1326, 1327, 0, 0, 1366, 0, 0, 0, 0, 0, 0, 0, 1351, 1349, 1304, 1304, 0, 0, 0, 0, 0, 0], 
[0, 0, 0, 0, 1357, 0, 1306, 1306, 0, 0, 0, 0, 0, 0, 0, 1366, 0, 0, 0, 0, 0, 0, 0, 0, 0, 0, 0, 1367, 0, 0, 0, 1367, 1359, 1349, 1304, 1304, 0, 0, 0, 0, 0, 0], 
[0, 0, 0, 0, 0, 0, 1306, 1306, 0, 0, 0, 1367, 0, 0, 0, 0, 0, 0, 0, 1349, 1367, 1351, 1349, 1296, 1297, 1297, 1297, 1297, 1297, 1297, 1297, 1298, 1296, 1297, 1311, 1304, 0, 0, 0, 1357, 1357, 0], 
[0, 1357, 0, 0, 0, 1357, 1306, 1306, 0, 0, 0, 0, 0, 0, 1367, 0, 0, 0, 1367, 1351, 1349, 1359, 1349, 1304, 1305, 1305, 1305, 1305, 1305, 1305, 1305, 1306, 1304, 1357, 1296, 1311, 0, 1357, 0, 0, 0, 0], 
[0, 0, 0, 0, 0, 0, 1306, 1306, 0, 0, 0, 0, 0, 0, 0, 0, 0, 0, 0, 1359, 0, 0, 0, 1312, 1313, 1313, 1313, 1313, 1313, 1313, 1313, 1314, 1304, 1296, 1311, 0, 0, 0, 0, 0, 0, 0], 
[0, 1357, 0, 0, 0, 0, 1306, 1310, 1297, 1297, 1298, 1358, 1349, 1358, 1367, 1349, 1367, 0, 0, 0, 0, 0, 0, 0, 0, 447, 0, 0, 1296, 1297, 1297, 1297, 1311, 1304, 0, 0, 0, 0, 0, 0, 0, 0], 
[0, 0, 0, 0, 0, 0, 1310, 1297, 1297, 1298, 1310, 1297, 1297, 1298, 1349, 1349, 1350, 0, 0, 0, 0, 0, 0, 0, 0, 0, 0, 0, 1304, 1296, 1297, 1297, 1297, 1311, 1357, 0, 0, 0, 0, 0, 0, 0], 
[0, 0, 0, 1357, 0, 0, 0, 1357, 0, 1310, 1297, 1298, 1357, 1310, 1297, 1298, 1359, 1349, 1349, 1367, 0, 0, 0, 0, 0, 0, 0, 0, 1304, 1304, 1357, 0, 0, 0, 0, 0, 0, 0, 1357, 0, 0, 0], 
[0, 0, 0, 0, 0, 0, 0, 0, 1357, 0, 0, 1310, 1297, 1297, 1298, 1310, 1297, 1297, 1297, 1297, 1297, 1297, 1299, 1300, 1301, 1297, 1297, 1297, 1311, 1304, 0, 0, 0, 0, 0, 0, 0, 0, 0, 0, 0, 0], 
[0, 0, 0, 0, 0, 0, 0, 0, 0, 0, 0, 0, 0, 0, 1310, 1297, 1297, 1297, 1297, 1297, 1297, 1297, 1297, 1297, 1297, 1297, 1297, 1297, 1297, 1311, 0, 0, 0, 0, 0, 0, 1357, 0, 0, 0, 0, 1357], 
[1357, 0, 0, 0, 0, 1357, 0, 0, 0, 0, 0, 0, 0, 0, 0, 0, 0, 1357, 0, 0, 0, 0, 0, 0, 1357, 0, 0, 0, 0, 1357, 0, 0, 0, 1357, 0, 0, 0, 0, 0, 0, 0, 0], 
[0, 0, 0, 0, 0, 0, 0, 0, 0, 0, 1357, 0, 0, 0, 0, 0, 0, 0, 1357, 0, 0, 0, 0, 1357, 0, 0, 0, 0, 0, 0, 0, 0, 1357, 0, 0, 0, 0, 0, 0, 0, 0, 0], 
[0, 0, 0, 0, 0, 0, 1357, 0, 0, 0, 0, 0, 0, 0, 0, 0, 0, 0, 0, 0, 0, 0, 0, 0, 0, 0, 0, 0, 0, 0, 0, 0, 0, 0, 0, 0, 0, 0, 0, 1357, 1357, 0], 
[0, 0, 1357, 0, 0, 0, 0, 0, 0, 0, 0, 0, 0, 0, 1357, 0, 0, 0, 0, 0, 0, 0, 0, 0, 0, 0, 0, 1357, 1357, 0, 0, 0, 0, 0, 0, 0, 0, 0, 0, 1357, 0, 0], 
[0, 0, 0, 0, 0, 0, 0, 0, 0, 1357, 0, 0, 0, 0, 0, 0, 0, 0, 1357, 0, 0, 0, 0, 0, 0, 0, 1357, 0, 0, 0, 0, 0, 0, 0, 0, 0, 1357, 0, 0, 0, 1357, 0], 
[0, 0, 0, 0, 0, 0, 0, 0, 0, 0, 0, 0, 0, 0, 0, 0, 0, 0, 0, 0, 0, 0, 0, 1357, 0, 0, 0, 0, 0, 0, 0, 0, 0, 0, 0, 0, 0, 0, 0, 0, 0, 0], 
[0, 0, 0, 0, 0, 1357, 0, 0, 0, 0, 0, 0, 1302, 1313, 1313, 1313, 1313, 1313, 1313, 1313, 1313, 1303, 0, 0, 0, 0, 0, 0, 0, 0, 0, 0, 0, 0, 0, 0, 0, 0, 0, 0, 0, 0], 
[0, 0, 0, 0, 0, 0, 0, 0, 0, 1357, 0, 1302, 1314, 1302, 1313, 1313, 1313, 1313, 1313, 1313, 1303, 1312, 1313, 1313, 1303, 0, 0, 0, 0, 1357, 0, 0, 0, 0, 0, 0, 0, 0, 0, 0, 0, 0], 
[0, 0, 0, 0, 0, 0, 0, 0, 1357, 1302, 1313, 1314, 1357, 1306, 0, 0, 0, 0, 1366, 0, 1312, 1313, 1313, 1303, 1304, 0, 1357, 0, 0, 0, 0, 0, 0, 0, 0, 0, 0, 0, 0, 0, 0, 0], 
[0, 0, 0, 0, 0, 0, 0, 0, 1302, 1314, 1302, 1313, 1313, 1314, 0, 0, 0, 0, 0, 0, 0, 447, 1349, 1304, 1304, 0, 0, 0, 0, 0, 0, 0, 0, 0, 0, 0, 0, 0, 0, 0, 0, 0], 
[0, 0, 0, 0, 0, 1357, 0, 0, 1306, 1302, 1314, 1349, 0, 0, 0, 0, 0, 0, 0, 0, 1349, 1349, 1351, 1304, 1304, 0, 0, 0, 0, 0, 0, 0, 0, 0, 0, 0, 0, 0, 0, 0, 0, 0], 
[0, 0, 1357, 0, 0, 0, 0, 0, 1306, 1306, 1349, 0, 0, 0, 0, 0, 0, 0, 0, 0, 0, 0, 1359, 1304, 1304, 0, 0, 0, 0, 0, 0, 0, 0, 0, 0, 0, 0, 0, 0, 0, 0, 0], 
[0, 1357, 1357, 0, 0, 0, 0, 0, 1306, 1306, 0, 0, 0, 0, 0, 0, 0, 0, 1349, 0, 0, 0, 0, 1304, 1304, 0, 1357, 0, 0, 0, 1357, 0, 0, 0, 0, 0, 0, 0, 0, 0, 0, 0], 
[0, 0, 0, 0, 0, 0, 1357, 0, 1306, 1306, 0, 0, 0, 1350, 0, 0, 0, 0, 0, 0, 0, 0, 0, 1304, 1304, 0, 0, 0, 0, 0, 0, 0, 0, 0, 0, 0, 0, 0, 0, 0, 0, 0], 
[0, 0, 0, 0, 0, 0, 0, 0, 1306, 1310, 1297, 1297, 1298, 1358, 1349, 1349, 0, 0, 0, 0, 0, 0, 1296, 1311, 1304, 0, 0, 0, 1357, 0, 0, 0, 0, 0, 0, 0, 0, 0, 0, 0, 0, 0], 
[0, 0, 0, 0, 0, 0, 0, 0, 1310, 1297, 1298, 1357, 1310, 1297, 1297, 1297, 1297, 1297, 1297, 1297, 1297, 1297, 1311, 1296, 1311, 1357, 0, 0, 1357, 0, 0, 0, 0, 0, 0, 0, 1357, 1357, 0, 1357, 1357, 0], 
[0, 0, 0, 0, 0, 1357, 0, 0, 1357, 0, 1310, 1297, 1297, 1297, 1297, 1297, 1297, 1297, 1297, 1297, 1297, 1297, 1297, 1311, 0, 0, 0, 0, 0, 0, 0, 0, 0, 0, 0, 0, 1357, 1357, 1357, 1357, 1357, 0], 
[0, 0, 0, 0, 0, 0, 0, 0, 0, 0, 0, 0, 0, 0, 0, 0, 0, 0, 1357, 0, 0, 0, 0, 0, 1357, 0, 0, 0, 0, 0, 0, 0, 0, 0, 0, 0, 1357, 0, 1357, 0, 1357, 0], 
[0, 1357, 0, 0, 0, 0, 0, 0, 0, 0, 0, 0, 0, 0, 1357, 0, 0, 0, 0, 0, 0, 0, 0, 0, 0, 0, 0, 1357, 0, 1357, 0, 0, 0, 0, 0, 0, 1357, 0, 1357, 0, 1357, 0], 
[0, 0, 0, 0, 0, 0, 0, 0, 0, 1357, 1357, 0, 0, 0, 0, 0, 0, 1357, 0, 0, 0, 0, 0, 0, 0, 0, 0, 0, 0, 0, 0, 0, 0, 0, 0, 0, 1357, 0, 0, 0, 1357, 0], 
[0, 0, 0, 0, 0, 0, 1357, 0, 0, 0, 0, 0, 0, 0, 0, 0, 0, 0, 0, 0, 0, 0, 1357, 0, 0, 0, 0, 0, 0, 0, 0, 0, 0, 0, 0, 0, 0, 0, 0, 0, 0, 0]], 

[[0, 0, 0, 0, 0, 0, 0, 0, 0, 0, 0, 0, 0, 0, 0, 0, 0, 0, 0, 0, 0, 0, 0, 0, 0, 0, 0, 0, 0, 0, 0, 0, 0, 0, 0, 0, 0, 0, 0, 0, 0, 0], 
[0, 0, 0, 0, 0, 0, 0, 0, 0, 0, 0, 0, 0, 0, 0, 0, 0, 0, 0, 0, 0, 0, 0, 0, 0, 0, 0, 0, 0, 0, 0, 0, 0, 0, 0, 0, 0, 0, 0, 0, 0, 0], 
[0, 0, 0, 0, 0, 0, 0, 0, 0, 0, 0, 0, 0, 0, 0, 0, 0, 0, 0, 0, 0, 0, 0, 0, 0, 0, 0, 0, 0, 0, 0, 0, 0, 0, 0, 0, 0, 0, 0, 0, 0, 0], 
[0, 0, 0, 0, 0, 0, 0, 0, 0, 0, 0, 0, 0, 0, 0, 0, 0, 0, 0, 0, 0, 0, 0, 0, 0, 0, 0, 0, 0, 0, 0, 0, 0, 0, 0, 0, 0, 0, 0, 0, 0, 0], 
[0, 0, 0, 0, 0, 0, 0, 0, 0, 0, 0, 0, 0, 0, 0, 0, 0, 0, 0, 0, 1350, 0, 0, 0, 0, 0, 0, 0, 0, 0, 0, 0, 0, 0, 0, 0, 0, 0, 0, 0, 0, 0], 
[0, 0, 0, 0, 0, 0, 0, 0, 0, 0, 0, 0, 0, 0, 0, 0, 0, 0, 0, 0, 0, 0, 0, 0, 0, 0, 0, 0, 0, 0, 0, 0, 0, 0, 0, 0, 0, 0, 0, 0, 0, 0], 
[0, 0, 0, 0, 0, 0, 0, 0, 0, 0, 0, 0, 0, 0, 0, 0, 0, 0, 0, 0, 0, 0, 0, 0, 0, 0, 0, 0, 0, 0, 0, 0, 0, 0, 0, 0, 0, 0, 0, 0, 0, 0], 
[0, 0, 0, 0, 0, 0, 0, 0, 0, 0, 0, 0, 0, 0, 0, 0, 0, 0, 0, 0, 0, 0, 0, 0, 0, 0, 0, 0, 0, 0, 0, 0, 0, 1350, 0, 0, 0, 0, 0, 0, 0, 0], 
[0, 0, 0, 0, 0, 0, 0, 0, 0, 0, 0, 0, 0, 0, 0, 0, 0, 0, 0, 0, 0, 0, 0, 0, 0, 0, 0, 0, 0, 0, 0, 0, 0, 0, 0, 0, 0, 0, 0, 0, 0, 0], 
[0, 0, 0, 0, 0, 0, 0, 0, 0, 0, 0, 0, 0, 0, 0, 0, 0, 0, 0, 0, 0, 0, 0, 0, 0, 0, 0, 0, 0, 0, 0, 0, 0, 0, 0, 0, 0, 0, 0, 0, 0, 0], 
[0, 0, 0, 0, 0, 0, 0, 0, 0, 0, 0, 0, 0, 0, 0, 0, 0, 0, 0, 0, 0, 0, 0, 0, 0, 0, 0, 0, 0, 0, 0, 0, 0, 0, 0, 0, 0, 0, 0, 0, 0, 0], 
[0, 0, 0, 0, 0, 0, 0, 0, 0, 0, 0, 0, 0, 0, 0, 0, 0, 0, 0, 0, 0, 0, 0, 0, 0, 0, 0, 0, 0, 0, 0, 0, 0, 0, 0, 0, 0, 0, 0, 0, 0, 0], 
[0, 0, 0, 0, 0, 0, 0, 0, 0, 0, 0, 0, 0, 0, 0, 0, 0, 0, 0, 0, 0, 0, 0, 0, 0, 0, 0, 0, 0, 0, 0, 0, 0, 0, 0, 0, 0, 0, 0, 0, 0, 0], 
[0, 0, 0, 0, 0, 0, 0, 0, 0, 0, 0, 0, 0, 0, 0, 0, 0, 0, 0, 0, 0, 0, 0, 0, 0, 0, 0, 0, 0, 0, 0, 0, 0, 0, 0, 0, 0, 0, 0, 0, 0, 0], 
[0, 0, 0, 0, 0, 0, 0, 0, 0, 0, 0, 1350, 0, 1350, 0, 0, 0, 0, 0, 0, 0, 0, 0, 0, 0, 0, 0, 0, 0, 0, 0, 0, 0, 0, 0, 0, 0, 0, 0, 0, 0, 0], 
[0, 0, 0, 0, 0, 0, 0, 0, 0, 0, 0, 0, 0, 0, 0, 0, 0, 0, 0, 0, 0, 0, 0, 0, 0, 0, 0, 0, 0, 0, 0, 0, 0, 0, 0, 0, 0, 0, 0, 0, 0, 0], 
[0, 0, 0, 0, 0, 0, 0, 0, 0, 0, 0, 0, 0, 0, 0, 0, 0, 0, 0, 0, 0, 0, 0, 0, 0, 0, 0, 0, 0, 0, 0, 0, 0, 0, 0, 0, 0, 0, 0, 0, 0, 0], 
[0, 0, 0, 0, 0, 0, 0, 0, 0, 0, 0, 0, 0, 0, 0, 0, 0, 0, 0, 0, 0, 0, 0, 0, 0, 0, 0, 0, 0, 0, 0, 0, 0, 0, 0, 0, 0, 0, 0, 0, 0, 0], 
[0, 0, 0, 0, 0, 0, 0, 0, 0, 0, 0, 0, 0, 0, 0, 0, 0, 0, 0, 0, 0, 0, 0, 1308, 0, 0, 0, 0, 0, 0, 0, 0, 0, 0, 0, 0, 0, 0, 0, 0, 0, 0], 
[0, 0, 0, 0, 0, 0, 0, 0, 0, 0, 0, 0, 0, 0, 0, 0, 0, 0, 0, 0, 0, 0, 0, 0, 0, 0, 0, 0, 0, 0, 0, 0, 0, 0, 0, 0, 0, 0, 0, 0, 0, 0], 
[0, 0, 0, 0, 0, 0, 0, 0, 0, 0, 0, 0, 0, 0, 0, 0, 0, 0, 0, 0, 0, 0, 0, 0, 0, 0, 0, 0, 0, 0, 0, 0, 0, 0, 0, 0, 0, 0, 0, 0, 0, 0], 
[0, 0, 0, 0, 0, 0, 0, 0, 0, 0, 0, 0, 0, 0, 0, 0, 0, 0, 0, 0, 0, 0, 0, 0, 0, 0, 0, 0, 0, 0, 0, 0, 0, 0, 0, 0, 0, 0, 0, 0, 0, 0], 
[0, 0, 0, 0, 0, 0, 0, 0, 0, 0, 0, 0, 0, 0, 0, 0, 0, 0, 0, 0, 0, 0, 0, 0, 0, 0, 0, 0, 0, 0, 0, 0, 0, 0, 0, 0, 0, 0, 0, 0, 0, 0], 
[0, 0, 0, 0, 0, 0, 0, 0, 0, 0, 0, 0, 0, 0, 0, 0, 0, 0, 0, 0, 0, 0, 0, 0, 0, 0, 0, 0, 0, 0, 0, 0, 0, 0, 0, 0, 0, 0, 0, 0, 0, 0], 
[0, 0, 0, 0, 0, 0, 0, 0, 0, 0, 0, 0, 0, 0, 0, 0, 0, 0, 0, 0, 0, 0, 0, 0, 0, 0, 0, 0, 0, 0, 0, 0, 0, 0, 0, 0, 0, 0, 0, 0, 0, 0], 
[0, 0, 0, 0, 0, 0, 0, 0, 0, 0, 0, 0, 0, 0, 0, 0, 0, 0, 0, 0, 0, 0, 0, 0, 0, 0, 0, 0, 0, 0, 0, 0, 0, 0, 0, 0, 0, 0, 0, 0, 0, 0], 
[0, 0, 0, 0, 0, 0, 0, 0, 0, 0, 0, 0, 0, 0, 0, 0, 0, 0, 0, 0, 0, 0, 0, 0, 0, 0, 0, 0, 0, 0, 0, 0, 0, 0, 0, 0, 0, 0, 0, 0, 0, 0], 
[0, 0, 0, 0, 0, 0, 0, 0, 0, 0, 0, 0, 0, 0, 0, 0, 0, 0, 0, 0, 0, 0, 0, 0, 0, 0, 0, 0, 0, 0, 0, 0, 0, 0, 0, 0, 0, 0, 0, 0, 0, 0], 
[0, 0, 0, 0, 0, 0, 0, 0, 0, 0, 0, 0, 0, 0, 0, 0, 0, 0, 0, 0, 0, 0, 0, 0, 0, 0, 0, 0, 0, 0, 0, 0, 0, 0, 0, 0, 0, 0, 0, 0, 0, 0], 
[0, 0, 0, 0, 0, 0, 0, 0, 0, 0, 0, 0, 0, 0, 0, 0, 0, 0, 0, 0, 0, 0, 0, 0, 0, 0, 0, 0, 0, 0, 0, 0, 0, 0, 0, 0, 0, 0, 0, 0, 0, 0], 
[0, 0, 0, 0, 0, 0, 0, 0, 0, 0, 0, 0, 0, 0, 0, 0, 0, 0, 0, 0, 0, 0, 0, 0, 0, 0, 0, 0, 0, 0, 0, 0, 0, 0, 0, 0, 0, 0, 0, 0, 0, 0], 
[0, 0, 0, 0, 0, 0, 0, 0, 0, 0, 1332, 0, 0, 0, 0, 0, 0, 0, 0, 0, 0, 0, 0, 0, 0, 0, 0, 0, 0, 0, 0, 0, 0, 0, 0, 0, 0, 0, 0, 0, 0, 0], 
[0, 0, 0, 0, 0, 0, 0, 0, 0, 0, 1340, 0, 0, 0, 0, 0, 0, 0, 0, 0, 0, 0, 0, 0, 0, 0, 0, 0, 0, 0, 0, 0, 0, 0, 0, 0, 0, 0, 0, 0, 0, 0], 
[0, 0, 0, 0, 0, 0, 0, 0, 0, 0, 0, 0, 0, 0, 0, 0, 0, 0, 0, 0, 0, 0, 0, 0, 0, 0, 0, 0, 0, 0, 0, 0, 0, 0, 0, 0, 0, 0, 0, 0, 0, 0], 
[0, 0, 0, 0, 0, 0, 0, 0, 0, 0, 0, 0, 0, 0, 0, 0, 0, 0, 0, 0, 0, 0, 0, 0, 0, 0, 0, 0, 0, 0, 0, 0, 0, 0, 0, 0, 0, 0, 0, 0, 0, 0], 
[0, 0, 0, 0, 0, 0, 0, 0, 0, 0, 0, 0, 0, 0, 0, 0, 0, 0, 0, 0, 0, 0, 0, 0, 0, 0, 0, 0, 0, 0, 0, 0, 0, 0, 0, 0, 0, 0, 0, 0, 0, 0], 
[0, 0, 0, 0, 0, 0, 0, 0, 0, 0, 0, 0, 0, 0, 0, 0, 0, 0, 0, 0, 0, 0, 0, 0, 0, 0, 0, 0, 0, 0, 0, 0, 0, 0, 0, 0, 0, 0, 0, 0, 0, 0], 
[0, 0, 0, 0, 0, 0, 0, 0, 0, 0, 0, 0, 0, 0, 0, 0, 0, 0, 0, 0, 0, 0, 0, 0, 0, 0, 0, 0, 0, 0, 0, 0, 0, 0, 0, 0, 0, 0, 0, 0, 0, 0], 
[0, 0, 0, 0, 0, 0, 0, 0, 0, 0, 0, 0, 0, 0, 0, 0, 0, 0, 0, 0, 0, 0, 0, 0, 0, 0, 0, 0, 0, 0, 0, 0, 0, 0, 0, 0, 0, 0, 0, 0, 0, 0], 
[0, 0, 0, 0, 0, 0, 0, 0, 0, 0, 0, 0, 0, 0, 0, 0, 0, 0, 0, 0, 0, 0, 0, 0, 0, 0, 0, 0, 0, 0, 0, 0, 0, 0, 0, 0, 0, 0, 0, 0, 0, 0], 
[0, 0, 0, 0, 0, 0, 0, 0, 0, 0, 0, 0, 0, 0, 0, 0, 0, 0, 0, 0, 0, 0, 0, 0, 0, 0, 0, 0, 0, 0, 0, 0, 0, 0, 0, 0, 0, 0, 0, 0, 0, 0]]]
}
}
