{
	"Map": {
		"id": 2,
		"map_display_x": 0,
		"map_display_y": 0,
		"width": 32,
		"height": 21,
		"xsize": 32,
		"ysize": 21,
		"zsize": 3,
		"Name" : "Lappet Town",
		"Parent" : "",
		"Tileset" : "Outside",
		"BattleBack" : "",
		"Autoplay_bgm" : true,
		"BGM" : "021-Field04",
		"Autoplay_bgs" : false,
		"BGS" : "",
		"Encounter_list" : [],
		"Encounter_step" : 30,
		"table": [[[808, 809, 808, 809, 808, 809, 808, 809, 808, 809, 808, 809, 808, 811, 395, 396, 810, 809, 808, 809, 808, 809, 808, 809, 808, 809, 808, 809, 808, 809, 808, 809], 
[800, 801, 800, 803, 818, 819, 818, 819, 818, 819, 818, 819, 818, 819, 403, 404, 818, 819, 818, 819, 818, 819, 818, 819, 802, 801, 800, 801, 800, 801, 800, 801], 
[808, 809, 808, 811, 395, 393, 393, 393, 393, 393, 393, 393, 393, 393, 422, 421, 393, 393, 393, 393, 393, 393, 393, 394, 810, 809, 808, 809, 808, 809, 808, 809], 
[800, 801, 800, 803, 403, 401, 401, 401, 401, 401, 401, 401, 401, 401, 401, 401, 401, 401, 401, 401, 401, 401, 401, 402, 802, 801, 800, 801, 800, 801, 800, 801], 
[808, 809, 808, 811, 403, 397, 409, 409, 409, 409, 409, 409, 398, 401, 397, 409, 409, 409, 409, 409, 409, 409, 414, 402, 810, 809, 808, 809, 808, 809, 808, 809], 
[800, 801, 800, 803, 403, 402, 388, 385, 385, 385, 385, 387, 400, 401, 402, 385, 385, 385, 385, 385, 387, 388, 403, 402, 802, 801, 800, 801, 800, 801, 800, 801], 
[808, 809, 808, 811, 403, 402, 385, 385, 385, 385, 385, 387, 400, 401, 402, 388, 387, 385, 387, 385, 385, 387, 403, 402, 810, 809, 808, 809, 808, 809, 808, 809], 
[818, 819, 818, 819, 403, 402, 387, 400, 401, 402, 387, 385, 400, 401, 402, 385, 400, 401, 402, 385, 387, 385, 403, 402, 802, 801, 800, 801, 800, 801, 800, 801], 
[385, 386, 387, 388, 403, 405, 393, 406, 401, 405, 393, 393, 406, 401, 405, 393, 406, 401, 405, 393, 393, 393, 422, 402, 810, 809, 808, 809, 808, 809, 808, 809], 
[386, 389, 395, 393, 422, 401, 401, 401, 401, 401, 401, 401, 401, 401, 401, 401, 401, 401, 401, 401, 401, 401, 401, 402, 802, 801, 800, 801, 800, 801, 800, 801], 
[387, 388, 403, 401, 401, 401, 401, 401, 401, 401, 401, 401, 401, 401, 397, 409, 409, 409, 409, 409, 409, 409, 414, 402, 810, 809, 808, 809, 808, 809, 808, 809], 
[386, 385, 411, 409, 414, 401, 397, 409, 409, 409, 409, 409, 398, 401, 402, 385, 385, 385, 385, 385, 385, 385, 403, 402, 802, 801, 800, 801, 800, 801, 800, 801], 
[810, 811, 810, 811, 403, 401, 402, 274, 260, 260, 276, 385, 400, 401, 402, 385, 385, 385, 385, 385, 385, 385, 403, 402, 810, 809, 808, 809, 808, 809, 808, 809], 
[800, 801, 800, 803, 403, 401, 402, 280, 268, 268, 278, 387, 400, 401, 402, 385, 385, 400, 401, 402, 385, 385, 403, 402, 802, 801, 800, 801, 800, 801, 800, 801], 
[808, 809, 808, 811, 403, 401, 402, 385, 387, 385, 388, 385, 400, 401, 405, 393, 393, 406, 401, 405, 393, 393, 422, 402, 810, 809, 808, 809, 808, 809, 808, 809], 
[800, 801, 800, 803, 403, 401, 405, 393, 393, 393, 393, 393, 406, 401, 397, 409, 409, 409, 409, 409, 409, 398, 401, 402, 802, 801, 800, 801, 800, 801, 800, 801], 
[808, 809, 808, 811, 403, 401, 401, 401, 401, 401, 401, 401, 401, 401, 419, 417, 417, 417, 417, 417, 417, 420, 401, 402, 810, 809, 808, 809, 808, 809, 808, 809], 
[800, 801, 800, 803, 411, 409, 409, 409, 409, 409, 409, 409, 398, 401, 401, 401, 401, 401, 401, 401, 401, 401, 401, 402, 802, 801, 800, 801, 800, 801, 800, 801], 
[808, 809, 808, 811, 385, 388, 387, 388, 385, 1088, 1089, 1090, 408, 398, 401, 401, 397, 409, 409, 409, 409, 409, 409, 410, 810, 809, 808, 809, 808, 809, 808, 809], 
[800, 801, 800, 803, 387, 385, 385, 389, 387, 1096, 1097, 1106, 1090, 400, 401, 401, 402, 388, 389, 388, 387, 385, 388, 387, 802, 801, 800, 801, 800, 801, 800, 801], 
[808, 809, 808, 811, 810, 811, 810, 811, 388, 1096, 1097, 1097, 1098, 408, 409, 409, 410, 388, 389, 385, 810, 811, 810, 811, 810, 809, 808, 809, 808, 809, 808, 809]], 

[[0, 0, 0, 0, 0, 0, 0, 0, 0, 0, 0, 0, 0, 0, 0, 0, 0, 0, 0, 0, 0, 0, 0, 0, 0, 0, 0, 0, 0, 0, 0, 0], 
[0, 0, 0, 0, 0, 0, 0, 0, 0, 0, 0, 0, 0, 0, 0, 0, 0, 0, 0, 0, 0, 0, 0, 0, 0, 0, 0, 0, 0, 0, 0, 0], 
[0, 0, 0, 0, 0, 0, 0, 0, 0, 0, 0, 0, 0, 0, 0, 0, 0, 0, 0, 0, 0, 0, 0, 0, 0, 0, 0, 0, 0, 0, 0, 0], 
[0, 0, 0, 0, 0, 0, 0, 1960, 1961, 1962, 1963, 1964, 0, 0, 0, 0, 1960, 1961, 1962, 1963, 1964, 0, 0, 0, 0, 0, 0, 0, 0, 0, 0, 0], 
[0, 0, 0, 0, 0, 0, 0, 1968, 1969, 1970, 1971, 1972, 0, 0, 0, 0, 1968, 1969, 1970, 1971, 1972, 0, 0, 0, 0, 0, 0, 0, 0, 0, 0, 0], 
[0, 0, 0, 0, 0, 0, 0, 1976, 1977, 1978, 1979, 1980, 0, 0, 0, 0, 1976, 1977, 1978, 1979, 1980, 0, 0, 0, 0, 0, 0, 0, 0, 0, 0, 0], 
[0, 0, 0, 0, 0, 0, 1346, 1984, 1985, 1986, 1987, 1988, 0, 0, 0, 1346, 1984, 1985, 1986, 1987, 1988, 0, 0, 0, 0, 0, 0, 0, 0, 0, 0, 0], 
[0, 0, 0, 0, 0, 0, 1354, 1992, 1993, 1994, 1995, 1996, 0, 0, 0, 1354, 1992, 1993, 1994, 1995, 1996, 0, 0, 0, 0, 0, 0, 0, 0, 0, 0, 0], 
[0, 0, 0, 0, 0, 0, 0, 0, 0, 0, 0, 0, 0, 0, 0, 0, 0, 0, 0, 0, 0, 0, 0, 0, 0, 0, 0, 0, 0, 0, 0, 0], 
[0, 0, 0, 0, 0, 0, 0, 0, 0, 0, 0, 0, 0, 0, 0, 3454, 3475, 3474, 3475, 3477, 3478, 3479, 0, 0, 0, 0, 0, 0, 0, 0, 0, 0], 
[0, 0, 0, 0, 0, 0, 0, 0, 0, 0, 0, 0, 0, 0, 0, 3462, 3483, 3482, 3483, 3485, 3486, 3487, 0, 0, 0, 0, 0, 0, 0, 0, 0, 0], 
[0, 0, 0, 0, 0, 0, 0, 1680, 1681, 1681, 1681, 1682, 0, 0, 0, 3470, 3491, 3490, 3491, 3493, 3494, 3495, 0, 0, 0, 0, 0, 0, 0, 0, 0, 0], 
[0, 0, 0, 0, 0, 0, 0, 0, 0, 0, 0, 0, 0, 0, 0, 3496, 3497, 3498, 3499, 3501, 3502, 3503, 0, 0, 0, 0, 0, 0, 0, 0, 0, 0], 
[0, 0, 0, 0, 0, 0, 0, 0, 0, 0, 0, 0, 0, 0, 0, 3504, 3505, 3506, 3507, 3509, 3510, 3511, 0, 0, 0, 0, 0, 0, 0, 0, 0, 0], 
[0, 0, 0, 0, 0, 0, 0, 0, 0, 0, 0, 0, 0, 0, 0, 0, 0, 0, 0, 0, 0, 0, 0, 0, 0, 0, 0, 0, 0, 0, 0, 0], 
[0, 0, 0, 0, 0, 0, 0, 0, 0, 0, 0, 0, 0, 0, 0, 0, 0, 0, 0, 0, 0, 0, 0, 0, 0, 0, 0, 0, 0, 0, 0, 0], 
[0, 0, 0, 0, 0, 0, 0, 0, 0, 0, 0, 0, 0, 0, 0, 1680, 1681, 1681, 1681, 1681, 1682, 0, 0, 0, 0, 0, 0, 0, 0, 0, 0, 0], 
[0, 0, 0, 0, 0, 0, 0, 0, 0, 0, 0, 0, 0, 0, 0, 0, 0, 0, 0, 0, 0, 0, 0, 0, 0, 0, 0, 0, 0, 0, 0, 0], 
[0, 0, 0, 0, 0, 0, 0, 0, 0, 1128, 1129, 1130, 0, 0, 0, 0, 0, 0, 0, 0, 0, 0, 0, 0, 0, 0, 0, 0, 0, 0, 0, 0], 
[0, 0, 0, 0, 0, 0, 0, 0, 0, 1136, 0, 1146, 1130, 0, 0, 0, 0, 0, 0, 0, 0, 0, 0, 0, 0, 0, 0, 0, 0, 0, 0, 0], 
[0, 0, 0, 0, 0, 0, 0, 0, 1689, 1136, 0, 0, 1138, 0, 0, 0, 0, 1680, 1681, 1682, 0, 0, 0, 0, 0, 0, 0, 0, 0, 0, 0, 0]], 

[[0, 0, 0, 0, 0, 0, 0, 0, 0, 0, 0, 0, 0, 0, 0, 0, 0, 0, 0, 0, 0, 0, 0, 0, 0, 0, 0, 0, 0, 0, 0, 0], 
[0, 0, 0, 0, 0, 0, 0, 0, 0, 0, 0, 0, 0, 0, 0, 0, 0, 0, 0, 0, 0, 0, 0, 0, 0, 0, 0, 0, 0, 0, 0, 0], 
[0, 0, 0, 0, 0, 0, 0, 0, 0, 0, 0, 0, 0, 0, 0, 0, 0, 0, 0, 0, 0, 0, 0, 0, 0, 0, 0, 0, 0, 0, 0, 0], 
[0, 0, 0, 0, 0, 0, 0, 0, 0, 0, 0, 0, 0, 0, 0, 0, 0, 0, 0, 0, 0, 0, 0, 0, 0, 0, 0, 0, 0, 0, 0, 0], 
[0, 0, 0, 0, 0, 0, 0, 0, 0, 0, 0, 0, 0, 0, 0, 0, 0, 0, 0, 0, 0, 0, 0, 0, 0, 0, 0, 0, 0, 0, 0, 0], 
[0, 0, 0, 0, 0, 0, 0, 0, 0, 0, 0, 0, 0, 0, 0, 0, 0, 0, 0, 0, 0, 0, 0, 0, 0, 0, 0, 0, 0, 0, 0, 0], 
[0, 0, 0, 0, 0, 0, 0, 0, 0, 0, 0, 0, 0, 0, 0, 0, 0, 0, 0, 0, 0, 0, 0, 0, 0, 0, 0, 0, 0, 0, 0, 0], 
[0, 0, 0, 0, 0, 0, 0, 0, 0, 0, 0, 0, 0, 0, 0, 0, 0, 0, 0, 0, 0, 0, 0, 0, 0, 0, 0, 0, 0, 0, 0, 0], 
[0, 0, 0, 0, 0, 0, 0, 0, 0, 0, 0, 0, 0, 0, 0, 0, 0, 0, 0, 0, 0, 0, 0, 0, 0, 0, 0, 0, 0, 0, 0, 0], 
[0, 0, 0, 0, 0, 0, 0, 0, 0, 0, 0, 0, 0, 0, 0, 0, 0, 0, 0, 0, 0, 0, 0, 0, 0, 0, 0, 0, 0, 0, 0, 0], 
[0, 0, 0, 0, 0, 0, 0, 0, 0, 0, 0, 0, 0, 0, 0, 0, 0, 0, 0, 0, 0, 0, 0, 0, 0, 0, 0, 0, 0, 0, 0, 0], 
[804, 805, 804, 805, 0, 0, 0, 0, 0, 0, 0, 0, 0, 0, 0, 0, 0, 0, 0, 0, 0, 0, 0, 0, 0, 0, 0, 0, 0, 0, 0, 0], 
[0, 0, 0, 0, 0, 0, 0, 0, 0, 0, 0, 0, 0, 0, 0, 0, 0, 0, 0, 0, 0, 0, 0, 0, 0, 0, 0, 0, 0, 0, 0, 0], 
[0, 0, 0, 0, 0, 0, 0, 0, 0, 0, 0, 0, 0, 0, 0, 0, 0, 0, 0, 0, 0, 0, 0, 0, 0, 0, 0, 0, 0, 0, 0, 0], 
[0, 0, 0, 0, 0, 0, 0, 0, 0, 0, 0, 0, 0, 0, 0, 0, 0, 0, 0, 0, 0, 0, 0, 0, 0, 0, 0, 0, 0, 0, 0, 0], 
[0, 0, 0, 0, 0, 0, 0, 0, 0, 0, 0, 0, 0, 0, 0, 0, 0, 0, 0, 0, 0, 0, 0, 0, 0, 0, 0, 0, 0, 0, 0, 0], 
[0, 0, 0, 0, 0, 0, 0, 0, 0, 0, 0, 0, 0, 0, 0, 0, 0, 0, 0, 0, 0, 0, 0, 0, 0, 0, 0, 0, 0, 0, 0, 0], 
[0, 0, 0, 0, 0, 0, 0, 0, 0, 0, 0, 0, 0, 0, 0, 0, 0, 0, 0, 0, 0, 0, 0, 0, 0, 0, 0, 0, 0, 0, 0, 0], 
[0, 0, 0, 0, 0, 0, 0, 0, 0, 0, 0, 0, 0, 0, 0, 0, 0, 0, 0, 0, 0, 0, 0, 0, 0, 0, 0, 0, 0, 0, 0, 0], 
[0, 0, 0, 0, 804, 805, 804, 805, 0, 0, 0, 0, 0, 0, 0, 0, 0, 0, 0, 0, 804, 805, 804, 805, 0, 0, 0, 0, 0, 0, 0, 0], 
[0, 0, 0, 0, 0, 0, 0, 0, 0, 0, 0, 0, 0, 0, 0, 0, 0, 0, 0, 1661, 0, 0, 0, 0, 0, 0, 0, 0, 0, 0, 0, 0]]]
}
}
