{
	"Map": {
		"id": 64,
		"map_display_x": 0,
		"map_display_y": 0,
		"width": 20,
		"height": 15,
		"xsize": 20,
		"ysize": 15,
		"zsize": 3,
		"Name" : "Battle Factory arena",
		"Parent" : "Battle Factory",
		"Tileset" : "Interior general",
		"BattleBack" : "",
		"Autoplay_bgm" : true,
		"BGM" : "PkmRS-BTower",
		"Autoplay_bgs" : false,
		"BGS" : "",
		"Encounter_list" : [],
		"Encounter_step" : 30,
		"table": [[[520, 521, 521, 521, 521, 521, 521, 521, 521, 521, 521, 521, 521, 521, 523, 542, 542, 542, 542, 542], 
[528, 529, 529, 529, 529, 529, 529, 529, 529, 529, 529, 529, 529, 529, 531, 542, 542, 542, 542, 542], 
[633, 641, 641, 641, 641, 641, 641, 641, 641, 641, 641, 641, 641, 641, 650, 542, 542, 542, 542, 542], 
[634, 624, 624, 624, 1081, 1106, 1106, 1106, 1106, 1106, 1083, 635, 624, 624, 624, 542, 542, 542, 542, 542], 
[634, 624, 624, 624, 1096, 651, 641, 641, 641, 641, 1096, 634, 624, 624, 624, 542, 542, 542, 542, 542], 
[634, 624, 624, 624, 649, 642, 624, 624, 624, 624, 649, 642, 624, 624, 624, 542, 542, 542, 542, 542], 
[634, 624, 624, 624, 1080, 635, 624, 624, 624, 624, 1080, 635, 624, 624, 624, 542, 542, 542, 542, 542], 
[634, 624, 624, 624, 1097, 1106, 1106, 1106, 1106, 1106, 1099, 634, 624, 624, 624, 542, 542, 542, 542, 542], 
[634, 624, 624, 624, 649, 641, 641, 641, 641, 641, 641, 642, 624, 633, 633, 542, 542, 542, 542, 542], 
[542, 542, 542, 542, 542, 542, 542, 542, 542, 542, 542, 542, 542, 542, 542, 542, 542, 542, 542, 542], 
[542, 542, 542, 542, 542, 542, 542, 542, 542, 542, 542, 542, 542, 542, 542, 542, 542, 542, 542, 542], 
[542, 542, 542, 542, 542, 542, 542, 542, 542, 542, 542, 542, 542, 542, 542, 542, 542, 542, 542, 542], 
[542, 542, 542, 542, 542, 542, 542, 542, 542, 542, 542, 542, 542, 542, 542, 542, 542, 542, 542, 542], 
[542, 542, 542, 542, 542, 542, 542, 542, 542, 542, 542, 542, 542, 542, 542, 542, 542, 542, 542, 542], 
[542, 542, 542, 542, 542, 542, 542, 542, 542, 542, 542, 542, 542, 542, 542, 542, 542, 542, 542, 542]], 

[[0, 0, 0, 1788, 0, 0, 0, 0, 0, 0, 1788, 389, 390, 391, 0, 0, 0, 0, 0, 0], 
[0, 1794, 1795, 1796, 0, 1795, 0, 1794, 1795, 0, 1796, 397, 398, 399, 1794, 0, 0, 0, 0, 0], 
[536, 1802, 1803, 1804, 0, 1803, 0, 1802, 1803, 0, 1804, 0, 0, 0, 1802, 0, 0, 0, 0, 0], 
[0, 0, 0, 0, 0, 0, 0, 0, 0, 0, 0, 0, 0, 0, 0, 0, 0, 0, 0, 0], 
[0, 0, 0, 0, 0, 0, 0, 0, 0, 0, 0, 0, 0, 0, 0, 0, 0, 0, 0, 0], 
[0, 0, 0, 0, 0, 0, 0, 0, 0, 0, 0, 0, 0, 0, 0, 0, 0, 0, 0, 0], 
[0, 0, 0, 0, 0, 0, 0, 0, 0, 0, 0, 0, 0, 1784, 1785, 0, 0, 0, 0, 0], 
[0, 0, 0, 0, 0, 0, 0, 0, 0, 0, 0, 0, 0, 1792, 1793, 0, 0, 0, 0, 0], 
[0, 1245, 1246, 1247, 0, 0, 0, 0, 0, 0, 0, 0, 0, 1800, 1801, 0, 0, 0, 0, 0], 
[0, 1253, 1254, 1255, 0, 0, 0, 0, 0, 0, 0, 0, 0, 0, 0, 0, 0, 0, 0, 0], 
[0, 0, 0, 0, 0, 0, 0, 0, 0, 0, 0, 0, 0, 0, 0, 0, 0, 0, 0, 0], 
[0, 0, 0, 0, 0, 0, 0, 0, 0, 0, 0, 0, 0, 0, 0, 0, 0, 0, 0, 0], 
[0, 0, 0, 0, 0, 0, 0, 0, 0, 0, 0, 0, 0, 0, 0, 0, 0, 0, 0, 0], 
[0, 0, 0, 0, 0, 0, 0, 0, 0, 0, 0, 0, 0, 0, 0, 0, 0, 0, 0, 0], 
[0, 0, 0, 0, 0, 0, 0, 0, 0, 0, 0, 0, 0, 0, 0, 0, 0, 0, 0, 0]], 

[[0, 0, 0, 0, 0, 0, 0, 0, 0, 0, 0, 0, 0, 0, 0, 0, 0, 0, 0, 0], 
[0, 0, 0, 0, 0, 0, 0, 0, 0, 0, 0, 0, 0, 0, 0, 0, 0, 0, 0, 0], 
[0, 0, 0, 0, 0, 0, 0, 0, 0, 0, 0, 0, 0, 0, 0, 0, 0, 0, 0, 0], 
[0, 0, 0, 0, 0, 0, 0, 0, 0, 0, 0, 0, 0, 0, 0, 0, 0, 0, 0, 0], 
[0, 0, 0, 0, 0, 0, 0, 0, 0, 0, 0, 0, 0, 0, 0, 0, 0, 0, 0, 0], 
[0, 0, 0, 0, 0, 0, 0, 0, 0, 0, 0, 0, 0, 0, 0, 0, 0, 0, 0, 0], 
[0, 0, 0, 0, 0, 0, 0, 0, 0, 0, 0, 0, 0, 0, 0, 0, 0, 0, 0, 0], 
[0, 0, 0, 0, 0, 0, 0, 0, 0, 0, 0, 0, 0, 0, 0, 0, 0, 0, 0, 0], 
[0, 0, 0, 0, 0, 0, 0, 0, 0, 0, 0, 0, 0, 0, 0, 0, 0, 0, 0, 0], 
[0, 0, 0, 0, 0, 0, 0, 0, 0, 0, 0, 0, 0, 0, 0, 0, 0, 0, 0, 0], 
[0, 0, 0, 0, 0, 0, 0, 0, 0, 0, 0, 0, 0, 0, 0, 0, 0, 0, 0, 0], 
[0, 0, 0, 0, 0, 0, 0, 0, 0, 0, 0, 0, 0, 0, 0, 0, 0, 0, 0, 0], 
[0, 0, 0, 0, 0, 0, 0, 0, 0, 0, 0, 0, 0, 0, 0, 0, 0, 0, 0, 0], 
[0, 0, 0, 0, 0, 0, 0, 0, 0, 0, 0, 0, 0, 0, 0, 0, 0, 0, 0, 0], 
[0, 0, 0, 0, 0, 0, 0, 0, 0, 0, 0, 0, 0, 0, 0, 0, 0, 0, 0, 0]]]
}
}
