{
	"Map": {
		"id": 40,
		"map_display_x": 0,
		"map_display_y": 0,
		"width": 33,
		"height": 21,
		"xsize": 33,
		"ysize": 21,
		"zsize": 3,
		"Name" : "Route 4",
		"Parent" : "Route 4",
		"Tileset" : "Outside",
		"BattleBack" : "",
		"Autoplay_bgm" : true,
		"BGM" : "cinnabar",
		"Autoplay_bgs" : false,
		"BGS" : "",
		"Encounter_list" : [],
		"Encounter_step" : 30,
		"table": [[[385, 385, 385, 385, 385, 385, 385, 385, 802, 801, 800, 801, 800, 801, 800, 801, 800, 801, 800, 801, 800, 801, 800, 801, 800, 801, 800, 801, 800, 801, 800, 801, 800], 
[385, 385, 385, 385, 385, 385, 385, 385, 810, 809, 808, 809, 808, 809, 808, 809, 808, 809, 808, 809, 808, 809, 808, 809, 808, 809, 808, 809, 808, 809, 808, 809, 808], 
[385, 385, 385, 385, 385, 385, 385, 385, 802, 801, 800, 801, 800, 801, 800, 801, 800, 801, 800, 801, 800, 801, 800, 801, 800, 801, 800, 801, 800, 801, 800, 801, 800], 
[385, 385, 385, 385, 385, 385, 385, 385, 810, 809, 808, 809, 808, 809, 808, 809, 808, 809, 808, 809, 808, 809, 808, 809, 808, 809, 808, 809, 808, 809, 808, 809, 808], 
[385, 385, 385, 385, 385, 385, 385, 1232, 818, 819, 818, 819, 818, 819, 818, 819, 818, 819, 818, 819, 818, 819, 818, 819, 818, 819, 818, 819, 818, 819, 818, 819, 818], 
[385, 385, 385, 385, 385, 385, 385, 385, 385, 385, 385, 385, 385, 385, 385, 385, 385, 385, 385, 385, 385, 385, 385, 385, 385, 385, 385, 385, 385, 385, 385, 385, 385], 
[385, 385, 385, 385, 385, 385, 385, 386, 388, 537, 538, 539, 385, 385, 385, 385, 385, 537, 538, 538, 538, 538, 538, 538, 538, 539, 388, 385, 389, 387, 390, 390, 390], 
[385, 385, 385, 385, 385, 385, 385, 389, 385, 545, 546, 556, 538, 538, 538, 538, 538, 558, 546, 546, 546, 546, 546, 546, 546, 547, 386, 387, 386, 385, 390, 390, 390], 
[385, 385, 385, 385, 385, 385, 385, 386, 387, 545, 546, 546, 546, 546, 546, 546, 546, 546, 546, 546, 540, 554, 554, 554, 554, 555, 385, 389, 388, 386, 390, 390, 390], 
[385, 385, 385, 385, 385, 385, 385, 385, 388, 553, 554, 554, 554, 554, 554, 554, 554, 554, 554, 554, 555, 385, 388, 386, 385, 389, 387, 386, 385, 387, 385, 386, 388], 
[385, 385, 385, 385, 385, 385, 385, 387, 386, 385, 388, 386, 385, 387, 389, 385, 386, 387, 385, 386, 385, 388, 387, 385, 388, 386, 385, 386, 388, 385, 389, 385, 386], 
[385, 385, 385, 385, 385, 385, 385, 385, 385, 385, 385, 385, 385, 385, 385, 385, 385, 385, 385, 385, 385, 385, 385, 385, 385, 385, 385, 385, 385, 385, 385, 385, 385], 
[385, 385, 385, 385, 385, 385, 385, 387, 386, 385, 388, 386, 385, 388, 389, 386, 385, 388, 386, 389, 385, 386, 387, 388, 385, 385, 385, 385, 385, 385, 385, 385, 385], 
[385, 385, 385, 385, 385, 385, 385, 385, 389, 537, 538, 539, 389, 386, 385, 387, 537, 538, 538, 538, 538, 538, 538, 538, 538, 538, 538, 538, 538, 538, 538, 538, 538], 
[385, 385, 385, 385, 385, 385, 385, 386, 388, 545, 546, 547, 385, 387, 388, 385, 545, 546, 546, 546, 546, 546, 546, 546, 546, 546, 546, 546, 546, 546, 546, 546, 546], 
[385, 385, 385, 385, 385, 385, 385, 389, 385, 545, 546, 547, 386, 389, 386, 387, 545, 546, 546, 546, 540, 554, 554, 554, 554, 554, 554, 554, 554, 554, 554, 554, 554], 
[385, 385, 385, 385, 385, 385, 385, 385, 386, 545, 546, 547, 388, 385, 388, 385, 545, 546, 546, 546, 547, 385, 385, 385, 385, 385, 385, 385, 385, 385, 385, 385, 385], 
[385, 385, 385, 385, 385, 385, 385, 386, 387, 545, 546, 547, 386, 387, 385, 386, 545, 546, 546, 546, 547, 385, 810, 811, 810, 811, 810, 811, 810, 811, 810, 811, 810], 
[385, 385, 385, 385, 385, 385, 385, 388, 385, 545, 546, 556, 538, 538, 538, 538, 558, 546, 546, 546, 547, 387, 802, 801, 800, 801, 800, 801, 800, 801, 800, 801, 800], 
[385, 385, 385, 385, 385, 385, 385, 386, 389, 545, 546, 546, 546, 546, 546, 546, 546, 546, 546, 546, 547, 386, 810, 809, 808, 809, 808, 809, 808, 809, 808, 809, 808], 
[385, 385, 385, 385, 385, 385, 385, 387, 385, 545, 546, 540, 554, 554, 554, 554, 542, 546, 540, 554, 555, 385, 802, 801, 800, 801, 800, 801, 800, 801, 800, 801, 800]], 

[[144, 144, 144, 144, 144, 144, 168, 72, 0, 0, 0, 0, 0, 0, 0, 0, 0, 0, 0, 0, 0, 0, 0, 0, 0, 0, 0, 0, 0, 0, 0, 0, 0], 
[144, 144, 144, 144, 144, 144, 168, 72, 0, 0, 0, 0, 0, 0, 0, 0, 0, 0, 0, 0, 0, 0, 0, 0, 0, 0, 0, 0, 0, 0, 0, 0, 0], 
[144, 144, 144, 144, 144, 148, 182, 72, 0, 0, 0, 0, 0, 0, 0, 0, 0, 0, 0, 0, 0, 0, 0, 0, 0, 0, 0, 0, 0, 0, 0, 0, 0], 
[144, 144, 144, 144, 144, 168, 52, 86, 0, 0, 0, 0, 0, 0, 0, 0, 0, 0, 0, 0, 0, 0, 0, 0, 0, 0, 0, 0, 0, 0, 0, 0, 0], 
[144, 144, 144, 144, 144, 168, 120, 0, 0, 0, 0, 0, 2048, 2049, 2050, 2050, 2051, 0, 0, 0, 0, 0, 0, 0, 0, 0, 0, 0, 0, 0, 0, 0, 0], 
[144, 144, 144, 144, 144, 168, 72, 1658, 1681, 1681, 1681, 1681, 2056, 2058, 2058, 2058, 2059, 1681, 1681, 1681, 1681, 1681, 1681, 1681, 1681, 1681, 1681, 1681, 1681, 1681, 1681, 1681, 1681], 
[144, 144, 144, 144, 144, 168, 72, 1664, 0, 0, 0, 0, 2064, 2066, 2066, 2066, 2067, 0, 0, 0, 0, 0, 0, 0, 0, 0, 0, 0, 0, 0, 0, 0, 0], 
[144, 144, 144, 144, 144, 168, 72, 1664, 0, 0, 0, 0, 0, 0, 0, 0, 0, 0, 0, 0, 0, 0, 0, 0, 0, 0, 0, 0, 0, 0, 0, 0, 0], 
[144, 144, 144, 144, 144, 168, 72, 1664, 0, 0, 0, 0, 0, 0, 0, 0, 0, 0, 0, 0, 0, 0, 0, 0, 0, 0, 0, 0, 0, 0, 0, 0, 0], 
[144, 144, 144, 144, 144, 168, 72, 1664, 0, 0, 0, 0, 0, 0, 0, 0, 0, 0, 0, 0, 0, 0, 0, 0, 0, 0, 0, 0, 0, 0, 0, 0, 0], 
[144, 144, 144, 144, 144, 168, 72, 1664, 0, 0, 0, 0, 0, 0, 0, 0, 0, 0, 0, 0, 0, 0, 0, 0, 0, 0, 0, 0, 0, 0, 0, 0, 0], 
[144, 144, 144, 144, 144, 168, 72, 1666, 1681, 1681, 1681, 1681, 1681, 1681, 1681, 1681, 1681, 1681, 1681, 1681, 1681, 1681, 1681, 1681, 1681, 1681, 1681, 1681, 1681, 1681, 1681, 1681, 1681], 
[144, 144, 144, 144, 144, 168, 72, 1664, 0, 0, 0, 0, 0, 0, 0, 0, 0, 0, 0, 0, 0, 0, 0, 0, 3296, 3360, 3361, 3361, 3361, 3361, 3362, 859, 859], 
[144, 144, 144, 144, 144, 168, 72, 1664, 0, 0, 0, 0, 0, 0, 0, 0, 0, 0, 0, 0, 0, 0, 0, 0, 3304, 3305, 3306, 3307, 3307, 3308, 3309, 3310, 0], 
[144, 144, 144, 144, 144, 168, 72, 1664, 0, 0, 0, 0, 0, 0, 0, 0, 0, 0, 0, 0, 0, 0, 0, 0, 3312, 3344, 3345, 3345, 3345, 3345, 3346, 3318, 0], 
[144, 144, 144, 144, 144, 168, 72, 1664, 0, 0, 0, 0, 0, 0, 0, 0, 0, 0, 0, 0, 0, 0, 0, 0, 3320, 3384, 3385, 3385, 3385, 3385, 3386, 3326, 0], 
[144, 144, 144, 144, 144, 168, 72, 1664, 0, 0, 0, 0, 0, 0, 0, 0, 0, 0, 0, 0, 0, 1662, 1681, 1681, 1681, 1681, 1681, 1681, 1681, 1681, 1681, 1681, 1681], 
[144, 144, 144, 144, 144, 168, 72, 1664, 0, 0, 0, 0, 0, 0, 0, 0, 0, 0, 0, 0, 0, 1665, 0, 0, 0, 0, 0, 0, 0, 0, 0, 0, 0], 
[144, 144, 144, 144, 144, 168, 72, 1664, 0, 0, 0, 0, 0, 0, 0, 0, 0, 0, 0, 0, 0, 1665, 0, 0, 0, 0, 0, 0, 0, 0, 0, 0, 0], 
[144, 144, 144, 144, 144, 168, 72, 1664, 0, 0, 0, 0, 0, 0, 0, 0, 0, 0, 0, 0, 0, 1665, 0, 0, 0, 0, 0, 0, 0, 0, 0, 0, 0], 
[144, 144, 144, 144, 144, 168, 72, 1664, 0, 0, 0, 0, 0, 0, 0, 0, 0, 0, 0, 0, 0, 1665, 0, 0, 0, 0, 0, 0, 0, 0, 0, 0, 0]], 

[[0, 0, 0, 0, 0, 0, 0, 0, 0, 0, 0, 0, 0, 0, 0, 0, 0, 0, 0, 0, 0, 0, 0, 0, 0, 0, 0, 0, 0, 0, 0, 0, 0], 
[0, 0, 0, 0, 0, 0, 0, 0, 0, 0, 0, 0, 0, 0, 0, 0, 0, 0, 0, 0, 0, 0, 0, 0, 0, 0, 0, 0, 0, 0, 0, 0, 0], 
[0, 0, 0, 0, 0, 0, 0, 0, 0, 0, 0, 0, 0, 0, 0, 0, 0, 0, 0, 0, 0, 0, 0, 0, 0, 0, 0, 0, 0, 0, 0, 0, 0], 
[0, 0, 0, 0, 0, 0, 0, 0, 0, 0, 0, 0, 0, 0, 0, 0, 0, 0, 0, 0, 0, 0, 0, 0, 0, 0, 0, 0, 0, 0, 0, 0, 0], 
[0, 0, 0, 0, 0, 0, 1131, 0, 0, 0, 0, 0, 0, 0, 0, 0, 0, 0, 0, 0, 0, 0, 0, 0, 0, 0, 0, 0, 0, 0, 0, 0, 0], 
[0, 0, 0, 0, 0, 0, 0, 0, 0, 0, 0, 0, 0, 0, 0, 0, 0, 0, 0, 0, 0, 0, 0, 0, 0, 0, 0, 0, 0, 0, 0, 0, 0], 
[0, 0, 0, 0, 0, 0, 0, 0, 0, 0, 0, 0, 0, 0, 0, 0, 0, 0, 0, 0, 0, 0, 0, 0, 0, 0, 0, 0, 0, 0, 0, 0, 0], 
[0, 0, 0, 0, 0, 0, 0, 0, 0, 0, 0, 0, 0, 0, 0, 0, 0, 0, 0, 0, 0, 0, 0, 0, 0, 0, 0, 0, 0, 0, 0, 0, 0], 
[0, 0, 0, 0, 0, 0, 0, 0, 0, 0, 0, 0, 0, 0, 0, 0, 0, 0, 0, 0, 0, 0, 0, 0, 0, 0, 0, 0, 0, 0, 0, 0, 0], 
[0, 0, 0, 0, 0, 0, 0, 0, 0, 0, 0, 0, 0, 0, 0, 0, 0, 0, 0, 0, 0, 0, 0, 0, 0, 0, 0, 0, 0, 0, 0, 0, 0], 
[0, 0, 0, 0, 0, 0, 0, 0, 0, 0, 0, 0, 0, 0, 0, 0, 0, 0, 0, 0, 0, 0, 0, 0, 0, 0, 0, 0, 0, 0, 0, 0, 0], 
[0, 0, 0, 0, 0, 0, 0, 0, 0, 0, 0, 0, 0, 0, 0, 0, 0, 0, 0, 0, 0, 0, 0, 0, 0, 3352, 3353, 3353, 3353, 3353, 3354, 0, 0], 
[0, 0, 0, 0, 0, 0, 0, 0, 0, 0, 0, 0, 0, 0, 0, 0, 0, 0, 0, 0, 0, 0, 0, 0, 0, 0, 0, 0, 0, 0, 0, 3302, 0], 
[0, 0, 0, 0, 0, 0, 0, 0, 0, 0, 0, 0, 0, 0, 0, 0, 0, 0, 0, 0, 0, 0, 0, 0, 0, 0, 0, 0, 0, 0, 0, 0, 0], 
[0, 0, 0, 0, 0, 0, 0, 0, 0, 0, 0, 0, 0, 0, 0, 0, 0, 0, 0, 0, 0, 0, 0, 0, 0, 0, 0, 0, 0, 0, 0, 0, 0], 
[0, 0, 0, 0, 0, 0, 0, 0, 0, 0, 0, 0, 0, 0, 0, 0, 0, 0, 0, 0, 0, 0, 0, 0, 0, 0, 0, 0, 0, 0, 0, 0, 0], 
[0, 0, 0, 0, 0, 0, 0, 0, 0, 0, 0, 0, 0, 0, 0, 0, 0, 0, 0, 0, 0, 0, 804, 805, 804, 805, 804, 805, 804, 805, 804, 805, 804], 
[0, 0, 0, 0, 0, 0, 0, 0, 0, 0, 0, 0, 0, 0, 0, 0, 0, 0, 0, 0, 0, 0, 0, 0, 0, 0, 0, 0, 0, 0, 0, 0, 0], 
[0, 0, 0, 0, 0, 0, 0, 0, 0, 0, 0, 0, 0, 0, 0, 0, 0, 0, 0, 0, 0, 0, 0, 0, 0, 0, 0, 0, 0, 0, 0, 0, 0], 
[0, 0, 0, 0, 0, 0, 0, 0, 0, 0, 0, 0, 0, 0, 0, 0, 0, 0, 0, 0, 0, 0, 0, 0, 0, 0, 0, 0, 0, 0, 0, 0, 0], 
[0, 0, 0, 0, 0, 0, 0, 0, 0, 0, 0, 0, 0, 0, 0, 0, 0, 0, 0, 0, 0, 0, 0, 0, 0, 0, 0, 0, 0, 0, 0, 0, 0]]]
}
}
