{
	"Map": {
		"id": 4,
		"map_display_x": 0,
		"map_display_y": 0,
		"width": 20,
		"height": 15,
		"xsize": 20,
		"ysize": 15,
		"zsize": 3,
		"Name" : "Pokémon Lab",
		"Parent" : "Lappet Town",
		"Tileset" : "Interior general",
		"BattleBack" : "",
		"Autoplay_bgm" : true,
		"BGM" : "Lab",
		"Autoplay_bgs" : false,
		"BGS" : "",
		"Encounter_list" : [],
		"Encounter_step" : 30,
		"table": [[[521, 521, 521, 521, 521, 521, 521, 521, 521, 521, 521, 521, 521, 542, 542, 542, 542, 542, 542, 542], 
[529, 529, 529, 529, 529, 529, 529, 529, 529, 529, 529, 529, 529, 542, 542, 542, 542, 542, 542, 542], 
[656, 657, 657, 657, 657, 657, 657, 657, 657, 657, 657, 657, 657, 542, 542, 542, 542, 542, 542, 542], 
[634, 624, 624, 624, 624, 624, 624, 624, 624, 624, 624, 624, 624, 542, 542, 542, 542, 542, 542, 542], 
[634, 624, 624, 624, 624, 624, 624, 624, 624, 624, 624, 624, 624, 542, 542, 542, 542, 542, 542, 542], 
[634, 624, 624, 624, 624, 624, 624, 624, 624, 624, 624, 624, 624, 542, 542, 542, 542, 542, 542, 542], 
[634, 624, 624, 624, 624, 624, 624, 624, 624, 624, 624, 624, 624, 542, 542, 542, 542, 542, 542, 542], 
[634, 624, 624, 624, 624, 624, 624, 624, 624, 624, 624, 624, 624, 542, 542, 542, 542, 542, 542, 542], 
[634, 624, 624, 624, 624, 624, 624, 624, 624, 624, 624, 624, 624, 542, 542, 542, 542, 542, 542, 542], 
[656, 657, 657, 657, 657, 624, 624, 624, 657, 657, 657, 657, 657, 542, 542, 542, 542, 542, 542, 542], 
[634, 624, 624, 624, 624, 624, 624, 624, 624, 624, 624, 624, 624, 542, 542, 542, 542, 542, 542, 542], 
[634, 624, 624, 624, 624, 624, 624, 624, 624, 624, 624, 624, 624, 542, 542, 542, 542, 542, 542, 542], 
[634, 624, 624, 624, 624, 624, 624, 624, 624, 624, 624, 624, 624, 542, 542, 542, 542, 542, 542, 542], 
[542, 542, 542, 542, 542, 542, 542, 542, 542, 542, 542, 542, 542, 542, 542, 542, 542, 542, 542, 542], 
[542, 542, 542, 542, 542, 542, 542, 542, 542, 542, 542, 542, 542, 542, 542, 542, 542, 542, 542, 542]], 

[[1788, 0, 0, 0, 0, 0, 1456, 1456, 1490, 1507, 1508, 1507, 1508, 0, 0, 0, 0, 0, 0, 0], 
[1796, 1794, 1904, 1906, 1904, 1906, 1464, 1464, 1498, 1515, 1516, 1515, 1516, 0, 0, 0, 0, 0, 0, 0], 
[1804, 1802, 1936, 1945, 1936, 1945, 0, 0, 0, 1523, 1524, 1523, 1524, 0, 0, 0, 0, 0, 0, 0], 
[1732, 1784, 1785, 0, 0, 0, 0, 0, 0, 0, 0, 0, 0, 0, 0, 0, 0, 0, 0, 0], 
[1732, 1792, 1793, 0, 0, 0, 0, 0, 2064, 2065, 2066, 0, 0, 0, 0, 0, 0, 0, 0, 0], 
[0, 1800, 1801, 0, 0, 0, 0, 0, 2072, 2073, 2074, 0, 0, 0, 0, 0, 0, 0, 0, 0], 
[0, 0, 0, 0, 0, 0, 0, 0, 0, 0, 0, 0, 0, 0, 0, 0, 0, 0, 0, 0], 
[1509, 1507, 1508, 1507, 1508, 0, 0, 0, 1507, 1508, 1507, 1508, 1509, 0, 0, 0, 0, 0, 0, 0], 
[1517, 1515, 1516, 1515, 1516, 0, 0, 0, 1515, 1516, 1515, 1516, 1517, 0, 0, 0, 0, 0, 0, 0], 
[1525, 1523, 1524, 1523, 1524, 0, 0, 0, 1523, 1524, 1523, 1524, 1525, 0, 0, 0, 0, 0, 0, 0], 
[0, 0, 0, 0, 0, 0, 0, 0, 0, 0, 0, 0, 0, 0, 0, 0, 0, 0, 0, 0], 
[1770, 0, 0, 0, 0, 0, 0, 0, 0, 0, 0, 0, 1770, 0, 0, 0, 0, 0, 0, 0], 
[1778, 0, 0, 0, 0, 1245, 1246, 1247, 0, 0, 0, 0, 1778, 0, 0, 0, 0, 0, 0, 0], 
[0, 0, 0, 0, 0, 1253, 1254, 1255, 0, 0, 0, 0, 0, 0, 0, 0, 0, 0, 0, 0], 
[0, 0, 0, 0, 0, 0, 0, 0, 0, 0, 0, 0, 0, 0, 0, 0, 0, 0, 0, 0]], 

[[0, 0, 0, 1844, 0, 0, 0, 0, 0, 0, 0, 0, 0, 0, 0, 0, 0, 0, 0, 0], 
[0, 0, 1851, 1852, 0, 0, 0, 0, 0, 0, 0, 0, 0, 0, 0, 0, 0, 0, 0, 0], 
[0, 0, 0, 0, 0, 0, 0, 0, 0, 0, 0, 0, 0, 0, 0, 0, 0, 0, 0, 0], 
[0, 0, 0, 0, 0, 0, 0, 0, 0, 0, 0, 0, 0, 0, 0, 0, 0, 0, 0, 0], 
[0, 0, 0, 0, 0, 0, 0, 0, 0, 0, 0, 0, 0, 0, 0, 0, 0, 0, 0, 0], 
[0, 0, 0, 0, 0, 0, 0, 0, 0, 0, 0, 0, 0, 0, 0, 0, 0, 0, 0, 0], 
[0, 0, 0, 0, 0, 0, 0, 0, 0, 0, 0, 0, 0, 0, 0, 0, 0, 0, 0, 0], 
[0, 0, 0, 0, 0, 0, 0, 0, 0, 0, 0, 0, 0, 0, 0, 0, 0, 0, 0, 0], 
[0, 0, 0, 0, 0, 0, 0, 0, 0, 0, 0, 0, 0, 0, 0, 0, 0, 0, 0, 0], 
[0, 0, 0, 0, 0, 0, 0, 0, 0, 0, 0, 0, 0, 0, 0, 0, 0, 0, 0, 0], 
[0, 0, 0, 0, 0, 0, 0, 0, 0, 0, 0, 0, 0, 0, 0, 0, 0, 0, 0, 0], 
[0, 0, 0, 0, 0, 0, 0, 0, 0, 0, 0, 0, 0, 0, 0, 0, 0, 0, 0, 0], 
[0, 0, 0, 0, 0, 0, 0, 0, 0, 0, 0, 0, 0, 0, 0, 0, 0, 0, 0, 0], 
[0, 0, 0, 0, 0, 0, 0, 0, 0, 0, 0, 0, 0, 0, 0, 0, 0, 0, 0, 0], 
[0, 0, 0, 0, 0, 0, 0, 0, 0, 0, 0, 0, 0, 0, 0, 0, 0, 0, 0, 0]]]
}
}
